cycle,Product ID,L1 Category,OLD,NEW,New-Old RL Qty,#Hub OOS karena WH,# New Hub OOS,Improvement in Hub OOS #,Verdict can we reduce oos potential?,Verdict can we mitigate oos?
1,34,,0,0,0,85,85,0,No,
1,36,Tata Rumah,160,160,0,8,8,0,No,
1,70,,13,13,0,2,2,0,No,
1,116,Alat Kesehatan,0,0,0,38,38,0,No,
1,152,Bahan Masak & Bumbu,0,0,0,2,2,0,No,
1,153,Makanan & Susu Bayi,0,0,0,12,12,0,No,
1,166,Kebutuhan Cuci Baju,96,24,-72,1,4,3,No,
1,178,Kebutuhan Cuci Baju,0,24,24,29,0,-29,100.00%,Yes
1,191,Makanan & Susu Bayi,0,24,24,6,0,-6,100.00%,Yes
1,209,Obat-obatan,72,96,24,11,9,-2,33.33%,
1,228,Obat-obatan,204,360,156,42,24,-18,76.47%,
1,234,Sarapan,0,48,48,20,0,-20,100.00%,Yes
1,258,Perawatan Mulut,144,144,0,10,10,0,No,
1,259,Vitamin,30,70,40,4,2,-2,133.33%,
1,295,Kebutuhan Cuci Baju,348,312,-36,1,2,1,No,
1,307,Kebersihan Badan,120,120,0,24,24,0,No,
1,352,Snack,0,100,100,12,0,-12,100.00%,Yes
1,356,Bahan Masak & Bumbu,17,17,0,2,2,0,No,
1,365,Biskuit,128,208,80,14,9,-5,62.50%,
1,399,Tepung & Bahan Kue,0,0,0,119,119,0,No,
1,418,Alat Kesehatan,0,0,0,77,77,0,No,
1,458,Sarapan,0,0,0,36,36,0,No,
1,520,Perawatan Mulut,408,360,-48,18,21,3,No,
1,551,Kebutuhan Ibu & Bayi,0,0,0,11,11,0,No,
1,561,,110,180,70,19,12,-7,63.64%,
1,567,Alat Kesehatan,72,72,0,4,4,0,No,
1,569,Bahan Masak & Bumbu,264,1080,816,150,37,-113,309.09%,
1,584,Kebutuhan Ibu & Bayi,0,0,0,7,7,0,No,
1,618,Minuman,0,0,0,40,40,0,No,
1,625,Biskuit,54,144,90,73,28,-45,166.67%,
1,635,Kebersihan Wajah,0,24,24,13,0,-13,100.00%,Yes
1,673,Kebutuhan Cuci Baju,552,552,0,10,10,0,No,
1,701,Kebutuhan Ibu & Bayi,32,24,-8,1,2,1,No,
1,712,Bahan Masak & Bumbu,0,480,480,15,0,-15,100.00%,Yes
1,713,Alat Tulis Kantor,288,264,-24,4,5,1,No,
1,724,Perawatan Hewan,60,90,30,6,4,-2,50.00%,
1,733,Tepung & Bahan Kue,0,0,0,11,11,0,No,
1,757,Kebutuhan Pokok,0,0,0,1,1,0,No,
1,771,Snack,0,0,0,143,143,0,No,
1,786,Makanan & Susu Bayi,0,0,0,4,4,0,No,
1,830,Bahan Masak & Bumbu,360,984,624,167,62,-105,173.33%,
1,846,Permen,0,0,0,92,92,0,No,
1,847,Obat-obatan,60,120,60,14,7,-7,100.00%,
1,854,Snack,684,684,0,3,3,0,No,
1,857,Tepung & Bahan Kue,72,0,-72,49,49,0,No,
1,859,Kebutuhan Pokok,96,168,72,4,3,-1,75.00%,
1,861,Perawatan Diri ,48,48,0,2,2,0,No,
1,862,Sarapan,0,24,24,19,0,-19,100.00%,Yes
1,865,Bahan Masak & Bumbu,0,0,0,2,2,0,No,
1,876,Kebutuhan Pokok,15640,15640,0,12,12,0,No,
1,902,Sarapan,48,24,-24,1,2,1,No,
1,917,Kebutuhan Ibu & Bayi,0,0,0,8,8,0,No,
1,921,Sarapan,0,0,0,1,1,0,No,
1,922,Make Up,384,384,0,6,6,0,No,
1,930,Perawatan Mulut,0,0,0,8,8,0,No,
1,936,Perawatan Diri ,0,0,0,20,20,0,No,
1,940,Perawatan Mulut,0,0,0,8,8,0,No,
1,943,Alat Tulis Kantor,0,0,0,17,17,0,No,
1,956,Sarapan,96,144,48,154,103,-51,50.00%,
1,957,Biskuit,144,288,144,5,3,-2,100.00%,
1,966,Perawatan Diri ,1760,1760,0,4,4,0,No,
1,967,Bahan Masak & Bumbu,0,0,0,5,5,0,No,
1,972,Bahan Masak & Bumbu,340,540,200,5,4,-1,58.82%,
1,973,Sarapan,96,132,36,5,4,-1,37.50%,
1,974,Sarapan,36,72,36,1,1,0,100.00%,
1,994,Alat Kesehatan,150,250,100,7,5,-2,66.67%,
1,996,Sarapan,0,48,48,112,0,-112,100.00%,Yes
1,1002,Kebersihan Wajah,360,432,72,171,143,-28,20.00%,
1,1003,Sarapan,96,96,0,2,2,0,No,
1,1010,Makanan & Susu Bayi,48,72,24,39,26,-13,50.00%,
1,1017,Bahan Masak & Bumbu,0,0,0,7,7,0,No,
1,1019,Snack,0,0,0,142,142,0,No,
1,1026,Perawatan Mulut,0,0,0,11,11,0,No,
1,1027,,144,144,0,47,47,0,No,
1,1030,Kebutuhan Ibu & Bayi,504,384,-120,1,2,1,No,
1,1036,Sarapan,0,0,0,2,2,0,No,
1,1042,Kebutuhan Ibu & Bayi,224,224,0,4,4,0,No,
1,1045,Kebutuhan Ibu & Bayi,228,228,0,2,2,0,No,
1,1046,Kebutuhan Ibu & Bayi,368,368,0,63,63,0,No,
1,1047,Kebutuhan Ibu & Bayi,0,0,0,11,11,0,No,
1,1048,Kebutuhan Ibu & Bayi,28,28,0,27,27,0,No,
1,1049,Sarapan,0,0,0,84,84,0,No,
1,1055,Sarapan,0,36,36,82,0,-82,100.00%,Yes
1,1077,Obat-obatan,48,48,0,2,2,0,No,
1,1081,Perawatan Rumah,0,0,0,1,1,0,No,
1,1090,Kebutuhan Dapur,24,48,24,3,2,-1,100.00%,
1,1092,Kebutuhan Dapur,0,0,0,32,32,0,No,
1,1098,Kebutuhan Dapur,0,48,48,6,0,-6,100.00%,Yes
1,1103,Kebutuhan Pokok,0,0,0,18,18,0,No,
1,1109,Biskuit,30,90,60,55,19,-36,200.00%,
1,1117,Makanan & Susu Bayi,0,0,0,25,25,0,No,
1,1122,Vitamin,0,0,0,10,10,0,No,
1,1128,Biskuit,144,240,96,20,12,-8,66.67%,
1,1129,Sarapan,300,840,540,63,23,-40,180.00%,
1,1135,Minuman,96,168,72,4,3,-1,75.00%,
1,1140,Kebersihan Wajah,264,216,-48,3,4,1,No,
1,1143,Bahan Masak & Bumbu,0,336,336,80,0,-80,100.00%,Yes
1,1147,Alat Tulis Kantor,0,30,30,7,0,-7,100.00%,Yes
1,1157,Otomotif,24,36,12,5,4,-1,50.00%,
1,1175,Perawatan Mulut,72,72,0,29,29,0,No,
1,1176,Perawatan Mulut,72,72,0,2,2,0,No,
1,1183,Bahan Masak & Bumbu,0,0,0,58,58,0,No,
1,1188,Bahan Masak & Bumbu,72,72,0,2,2,0,No,
1,1190,Perawatan Mulut,24,0,-24,1,1,0,No,
1,1219,Susu & Olahan Susu,432,528,96,19,16,-3,22.22%,
1,1225,Kebutuhan Cuci Baju,72,96,24,5,4,-1,33.33%,
1,1226,Kebutuhan Cuci Baju,72,120,48,52,32,-20,66.67%,
1,1229,Alat Kesehatan,276,408,132,137,93,-44,47.83%,
1,1234,Perawatan Rumah,168,252,84,21,14,-7,50.00%,
1,1237,,72,120,48,132,80,-52,66.67%,
1,1238,,84,96,12,81,71,-10,14.29%,
1,1239,,90,108,18,73,61,-12,20.00%,
1,1240,Snack,30,414,384,107,8,-99,1280.00%,
1,1242,Snack,360,816,456,103,46,-57,126.67%,
1,1243,Snack,408,696,288,121,71,-50,70.59%,
1,1253,Obat-obatan,72,72,0,4,4,0,No,
1,1271,Tepung & Bahan Kue,216,216,0,3,3,0,No,
1,1281,Tepung & Bahan Kue,360,456,96,4,4,0,26.67%,
1,1296,Biskuit,1320,1848,528,8,6,-2,40.00%,
1,1297,Perawatan Rumah,204,282,78,12,9,-3,38.24%,
1,1320,Perawatan Diri ,528,528,0,17,17,0,No,
1,1339,Obat-obatan,210,115,-95,1,2,1,No,
1,1348,Susu & Olahan Susu,912,1236,324,3,3,0,35.53%,
1,1350,Vitamin,0,0,0,156,156,0,No,
1,1362,Kebersihan Badan,27,27,0,25,25,0,No,
1,1381,Biskuit,90,90,0,32,32,0,No,
1,1382,Kebutuhan Pokok,920,1060,140,40,35,-5,15.22%,
1,1385,Obat-obatan,48,60,12,6,5,-1,25.00%,
1,1387,Obat-obatan,24,24,0,9,9,0,No,
1,1394,Obat-obatan,12,12,0,2,2,0,No,
1,1403,Snack,40,80,40,2,1,-1,100.00%,
1,1410,Kebutuhan Pokok,1560,4296,2736,36,14,-22,175.38%,
1,1424,Bahan Masak & Bumbu,0,0,0,35,35,0,No,
1,1428,Biskuit,60,210,150,28,8,-20,250.00%,
1,1450,Bahan Masak & Bumbu,0,252,252,3,0,-3,100.00%,Yes
1,1460,Bahan Masak & Bumbu,90,180,90,9,5,-4,100.00%,
1,1465,Bahan Masak & Bumbu,170,310,140,13,8,-5,82.35%,
1,1468,Bahan Masak & Bumbu,10,30,20,6,2,-4,200.00%,
1,1469,Bahan Masak & Bumbu,50,50,0,32,32,0,No,
1,1471,Bahan Masak & Bumbu,70,90,20,17,14,-3,28.57%,
1,1473,Bahan Masak & Bumbu,40,70,30,37,22,-15,75.00%,
1,1475,Bahan Masak & Bumbu,100,150,50,6,4,-2,50.00%,
1,1478,,66,96,30,29,20,-9,45.45%,
1,1489,Minuman,24,24,0,6,6,0,No,
1,1490,Minuman,320,520,200,3,2,-1,62.50%,
1,1500,Bahan Masak & Bumbu,96,528,432,142,26,-116,450.00%,
1,1502,Bahan Masak & Bumbu,24,108,84,41,10,-31,350.00%,
1,1503,Bahan Masak & Bumbu,48,132,84,84,31,-53,175.00%,
1,1504,Bahan Masak & Bumbu,0,132,132,103,0,-103,100.00%,Yes
1,1515,Tepung & Bahan Kue,768,1080,312,2,2,0,40.63%,
1,1524,,300,350,50,108,93,-15,16.67%,
1,1525,Perawatan Rumah,0,0,0,30,30,0,No,
1,1526,Perawatan Rumah,144,240,96,28,17,-11,66.67%,
1,1535,,180,216,36,1,1,0,20.00%,
1,1546,Minuman,0,0,0,1,1,0,No,
1,1558,Kebutuhan Dapur,2124,1872,-252,23,27,4,No,
1,1564,Kebutuhan Cuci Baju,618,540,-78,16,19,3,No,
1,1585,Makanan & Susu Bayi,0,20,20,14,0,-14,100.00%,Yes
1,1587,Makanan & Susu Bayi,0,0,0,2,2,0,No,
1,1602,Kebersihan Badan,252,276,24,2,2,0,9.52%,
1,1606,Kebersihan Badan,72,72,0,11,11,0,No,
1,1607,Kebersihan Badan,0,0,0,82,82,0,No,
1,1609,Kebutuhan Cuci Baju,24,12,-12,1,2,1,No,
1,1611,Kebersihan Badan,48,48,0,15,15,0,No,
1,1612,Kebersihan Badan,144,144,0,13,13,0,No,
1,1619,Sarapan,48,48,0,31,31,0,No,
1,1623,Perawatan Rumah,264,312,48,64,55,-9,18.18%,
1,1624,Perawatan Rumah,312,348,36,6,6,0,11.54%,
1,1633,Kebersihan Badan,96,120,24,14,12,-2,25.00%,
1,1636,,528,576,48,42,39,-3,9.09%,
1,1637,Perawatan Mulut,240,288,48,43,36,-7,20.00%,
1,1643,,96,144,48,163,109,-54,50.00%,
1,1651,Kebutuhan Pokok,40,40,0,4,4,0,No,
1,1672,Sarapan,84,84,0,84,84,0,No,
1,1679,Sarapan,96,48,-48,16,32,16,No,
1,1680,Sarapan,0,0,0,2,2,0,No,
1,1683,Susu & Olahan Susu,24,12,-12,2,4,2,No,
1,1686,Alat Tulis Kantor,864,864,0,34,34,0,No,
1,1735,Bahan Masak & Bumbu,96,96,0,8,8,0,No,
1,1752,Tepung & Bahan Kue,132,168,36,91,72,-19,27.27%,
1,1771,Bahan Masak & Bumbu,288,288,0,14,14,0,No,
1,1774,Snack,1350,1620,270,4,4,0,20.00%,
1,1778,Kebutuhan Cuci Baju,60,60,0,19,19,0,No,
1,1779,Kebutuhan Cuci Baju,600,636,36,47,45,-2,6.00%,
1,1783,Kebutuhan Pokok,600,520,-80,1,2,1,No,
1,1784,Kebutuhan Pokok,0,0,0,14,14,0,No,
1,1785,Kebutuhan Pokok,360,360,0,4,4,0,No,
1,1791,Perawatan Rumah,504,600,96,16,14,-2,19.05%,
1,1802,Bahan Masak & Bumbu,30,30,0,12,12,0,No,
1,1812,Biskuit,80,40,-40,1,2,1,No,
1,1816,Bahan Masak & Bumbu,0,0,0,24,24,0,No,
1,1818,Bahan Masak & Bumbu,60,60,0,68,68,0,No,
1,1833,Kebutuhan Pokok,0,0,0,32,32,0,No,
1,1865,,240,360,120,5,4,-1,50.00%,
1,1896,Biskuit,0,360,360,14,0,-14,100.00%,Yes
1,1899,Cokelat,0,0,0,15,15,0,No,
1,1914,Kebutuhan Cuci Baju,0,0,0,31,31,0,No,
1,1947,Kebutuhan Ibu & Bayi,132,132,0,3,3,0,No,
1,1984,Tepung & Bahan Kue,792,576,-216,8,11,3,No,
1,2007,Kebutuhan Pokok,0,0,0,138,138,0,No,
1,2008,Bahan Masak & Bumbu,1056,1116,60,34,33,-1,5.68%,
1,2018,Bahan Masak & Bumbu,336,384,48,43,38,-5,14.29%,
1,2019,Bahan Masak & Bumbu,624,672,48,56,52,-4,7.69%,
1,2022,Kebersihan Badan,128,128,0,6,6,0,No,
1,2023,Kebersihan Badan,168,180,12,19,18,-1,7.14%,
1,2024,Kebersihan Badan,60,60,0,43,43,0,No,
1,2025,Kebersihan Badan,120,132,12,11,10,-1,10.00%,
1,2034,Kebersihan Badan,852,852,0,18,18,0,No,
1,2043,Bahan Masak & Bumbu,18,36,18,1,1,0,100.00%,
1,2064,Bahan Masak & Bumbu,864,1296,432,36,24,-12,50.00%,
1,2065,Bahan Masak & Bumbu,192,288,96,58,39,-19,50.00%,
1,2067,Bahan Masak & Bumbu,150,210,60,18,13,-5,40.00%,
1,2077,Cokelat,0,0,0,56,56,0,No,
1,2079,Cokelat,0,0,0,58,58,0,No,
1,2080,Shampoo & Conditioner,0,0,0,6,6,0,No,
1,2086,Biskuit,320,320,0,59,59,0,No,
1,2090,Permen,384,324,-60,1,2,1,No,
1,2091,Permen,0,0,0,52,52,0,No,
1,2093,Permen,168,216,48,1,1,0,28.57%,
1,2094,Permen,144,144,0,22,22,0,No,
1,2104,Susu & Olahan Susu,168,384,216,36,16,-20,128.57%,
1,2109,Biskuit,0,90,90,13,0,-13,100.00%,Yes
1,2118,Perawatan Mulut,264,240,-24,1,2,1,No,
1,2120,Permen,72,72,0,9,9,0,No,
1,2146,Obat-obatan,0,0,0,1,1,0,No,
1,2149,Bahan Masak & Bumbu,0,320,320,4,0,-4,100.00%,Yes
1,2162,Kebutuhan Pokok,0,0,0,91,91,0,No,
1,2167,Obat-obatan,0,0,0,1,1,0,No,
1,2168,Obat-obatan,48,60,12,30,24,-6,25.00%,
1,2183,Perawatan Mulut,162,162,0,7,7,0,No,
1,2184,Perawatan Mulut,432,468,36,54,50,-4,8.33%,
1,2185,Perawatan Mulut,0,0,0,1,1,0,No,
1,2186,,0,0,0,77,77,0,No,
1,2190,Biskuit,270,540,270,5,3,-2,100.00%,
1,2191,Minuman,72,180,108,60,24,-36,150.00%,
1,2204,Shampoo & Conditioner,72,72,0,20,20,0,No,
1,2211,Kebersihan Badan,108,120,12,43,39,-4,11.11%,
1,2212,Kebersihan Badan,120,144,24,11,10,-1,20.00%,
1,2217,Minuman,48,144,96,20,7,-13,200.00%,
1,2221,Minuman,24,72,48,2,1,-1,200.00%,
1,2223,Minuman,120,264,144,47,22,-25,120.00%,
1,2228,Sarapan,0,24,24,34,0,-34,100.00%,Yes
1,2229,Sarapan,60,60,0,2,2,0,No,
1,2232,Sarapan,740,860,120,5,5,0,16.22%,
1,2252,Minuman,12,0,-12,9,9,0,No,
1,2267,Sarapan,288,336,48,58,50,-8,16.67%,
1,2268,Minuman,0,0,0,2,2,0,No,
1,2272,Minuman,96,192,96,8,4,-4,100.00%,
1,2275,Minuman,48,108,60,16,8,-8,125.00%,
1,2286,Minuman,72,72,0,56,56,0,No,
1,2289,Kebersihan Badan,24,48,24,12,6,-6,100.00%,
1,2295,Perawatan Diri ,12,24,12,7,4,-3,100.00%,
1,2298,Shampoo & Conditioner,0,0,0,6,6,0,No,
1,2307,Perawatan Mulut,96,96,0,21,21,0,No,
1,2309,Perawatan Mulut,336,288,-48,21,25,4,No,
1,2323,Bahan Masak & Bumbu,0,10,10,23,0,-23,100.00%,Yes
1,2325,,96,168,72,1,1,0,75.00%,
1,2326,Snack,0,48,48,16,0,-16,100.00%,Yes
1,2327,Kebersihan Badan,96,96,0,23,23,0,No,
1,2333,Biskuit,96,264,168,203,74,-129,175.00%,
1,2351,Cokelat,0,0,0,174,174,0,No,
1,2355,Kebutuhan Pokok,12,48,36,31,8,-23,300.00%,
1,2358,Kebutuhan Pokok,60,84,24,44,32,-12,40.00%,
1,2360,Kebutuhan Pokok,60,105,45,81,47,-34,75.00%,
1,2372,Cokelat,0,0,0,3,3,0,No,
1,2373,Cokelat,0,0,0,6,6,0,No,
1,2377,Perawatan Diri ,1110,1290,180,2,2,0,16.22%,
1,2379,Perawatan Diri ,1704,1704,0,9,9,0,No,
1,2380,Perawatan Diri ,1032,1032,0,57,57,0,No,
1,2381,Perawatan Diri ,684,684,0,14,14,0,No,
1,2382,Kebutuhan Pokok,1944,1944,0,62,62,0,No,
1,2405,Perawatan Diri ,288,240,-48,23,28,5,No,
1,2411,Bahan Masak & Bumbu,0,0,0,26,26,0,No,
1,2418,Minuman,0,0,0,14,14,0,No,
1,2421,Minuman,576,840,264,22,16,-6,45.83%,
1,2434,Minuman,0,0,0,33,33,0,No,
1,2460,Elektronik,0,0,0,203,203,0,No,
1,2461,Elektronik,432,864,432,203,102,-101,100.00%,
1,2462,Snack,2820,2820,0,49,49,0,No,
1,2476,Elektronik,0,0,0,46,46,0,No,
1,2484,Snack,1116,1116,0,68,68,0,No,
1,2521,Cokelat,0,0,0,15,15,0,No,
1,2581,Vitamin,100,100,0,9,9,0,No,
1,2582,Vitamin,0,0,0,63,63,0,No,
1,2590,Perawatan Diri ,0,0,0,1,1,0,No,
1,2603,Biskuit,24,24,0,21,21,0,No,
1,2614,Snack,0,0,0,4,4,0,No,
1,2668,Alat Tulis Kantor,0,0,0,2,2,0,No,
1,2673,Sarapan,12,12,0,16,16,0,No,
1,2700,Kebutuhan Cuci Baju,636,570,-66,21,24,3,No,
1,2753,Snack,384,600,216,5,4,-1,56.25%,
1,2764,Susu & Olahan Susu,96,72,-24,23,31,8,No,
1,2788,Kebersihan Badan,84,84,0,1,1,0,No,
1,2789,Skincare,84,84,0,2,2,0,No,
1,2790,Kebersihan Badan,96,96,0,2,2,0,No,
1,2792,Kebersihan Badan,0,0,0,4,4,0,No,
1,2793,Skincare,0,0,0,8,8,0,No,
1,2809,Biskuit,60,80,20,29,22,-7,33.33%,
1,2827,Minuman,0,0,0,7,7,0,No,
1,2873,Sarapan,126,261,135,68,33,-35,107.14%,
1,2874,Sarapan,414,873,459,67,32,-35,110.87%,
1,2876,Sarapan,300,624,324,40,20,-20,108.00%,
1,2878,Susu & Olahan Susu,104,104,0,3,3,0,No,
1,2887,Makanan & Susu Bayi,132,180,48,65,48,-17,36.36%,
1,2888,Makanan & Susu Bayi,156,204,48,19,15,-4,30.77%,
1,2904,Kebutuhan Cuci Baju,204,216,12,25,24,-1,5.88%,
1,2906,Kebutuhan Cuci Baju,708,780,72,139,127,-12,10.17%,
1,2907,Kebutuhan Cuci Baju,228,246,18,54,51,-3,7.89%,
1,2909,Alat Tulis Kantor,120,72,-48,2,4,2,No,
1,2910,Sarapan,24,120,96,22,5,-17,400.00%,
1,2919,Kebutuhan Ibu & Bayi,60,48,-12,1,2,1,No,
1,2920,Tepung & Bahan Kue,240,192,-48,16,20,4,No,
1,2944,Bahan Masak & Bumbu,168,168,0,12,12,0,No,
1,2973,Minuman,0,10,10,11,0,-11,100.00%,Yes
1,2997,Perlengkapan Pesta,33,62,29,122,65,-57,87.88%,
1,3006,,48,96,48,6,3,-3,100.00%,
1,3035,Sarapan,180,380,200,2,1,-1,111.11%,
1,3037,Sarapan,0,20,20,5,0,-5,100.00%,Yes
1,3107,Tata Rumah,0,0,0,20,20,0,No,
1,3135,Cokelat,0,0,0,174,174,0,No,
1,3141,Biskuit,24,72,48,203,68,-135,200.00%,
1,3142,Biskuit,24,288,264,203,17,-186,1100.00%,
1,3353,Biskuit,0,228,228,60,0,-60,100.00%,Yes
1,3354,Cokelat,0,0,0,15,15,0,No,
1,3367,Bahan Masak & Bumbu,0,0,0,18,18,0,No,
1,3396,Perawatan Diri ,360,360,0,33,33,0,No,
1,3432,Biskuit,48,120,72,25,10,-15,150.00%,
1,3433,Biskuit,96,240,144,33,14,-19,150.00%,
1,3541,Permen,0,48,48,23,0,-23,100.00%,Yes
1,3573,Kebutuhan Pokok,1390,1390,0,9,9,0,No,
1,3577,Skincare,72,72,0,17,17,0,No,
1,3639,,48,48,0,7,7,0,No,
1,3643,Sarapan,120,264,144,13,6,-7,120.00%,
1,3664,Permen,48,48,0,9,9,0,No,
1,3675,Snack,96,144,48,4,3,-1,50.00%,
1,3676,Snack,0,96,96,62,0,-62,100.00%,Yes
1,3706,Obat-obatan,24,24,0,5,5,0,No,
1,3709,Vitamin,100,100,0,14,14,0,No,
1,3727,Kebutuhan Pokok,200,280,80,1,1,0,40.00%,
1,3732,Biskuit,60,120,60,57,29,-28,100.00%,
1,3764,Kebutuhan Ibu & Bayi,204,204,0,4,4,0,No,
1,3765,Kebutuhan Ibu & Bayi,240,240,0,5,5,0,No,
1,3796,Tepung & Bahan Kue,840,840,0,22,22,0,No,
1,3813,Make Up,20,27,7,1,1,0,35.00%,
1,3859,Susu & Olahan Susu,24,24,0,12,12,0,No,
1,3913,Sarapan,192,312,120,42,26,-16,62.50%,
1,3918,Bahan Masak & Bumbu,144,0,-144,6,6,0,No,
1,3920,,288,288,0,29,29,0,No,
1,3984,Susu & Olahan Susu,0,0,0,3,3,0,No,
1,3993,Snack,0,0,0,34,34,0,No,
1,4020,Kebutuhan Pokok,52,52,0,68,68,0,No,
1,4022,Kebutuhan Pokok,0,0,0,179,179,0,No,
1,4146,Kebersihan Badan,12,24,12,24,12,-12,100.00%,
1,4153,Shampoo & Conditioner,192,192,0,178,178,0,No,
1,4155,Perawatan Diri ,48,48,0,22,22,0,No,
1,4183,Kebutuhan Ibu & Bayi,176,168,-8,8,9,1,No,
1,4184,Kebutuhan Ibu & Bayi,0,0,0,8,8,0,No,
1,4200,Susu & Olahan Susu,0,0,0,8,8,0,No,
1,4227,Perawatan Mulut,0,0,0,12,12,0,No,
1,4240,Obat-obatan,66,66,0,3,3,0,No,
1,4304,Kebersihan Badan,216,216,0,4,4,0,No,
1,4315,Gas & Air Galon,0,20532,20532,58,0,-58,100.00%,Yes
1,4320,Kebutuhan Pokok,498,498,0,15,15,0,No,
1,4344,Makanan & Susu Bayi,0,0,0,2,2,0,No,
1,4345,Makanan & Susu Bayi,0,0,0,3,3,0,No,
1,4347,Makanan & Susu Bayi,0,24,24,63,0,-63,100.00%,Yes
1,4357,Snack,0,0,0,22,22,0,No,
1,4359,,0,0,0,4,4,0,No,
1,4395,Perawatan Hewan,96,96,0,4,4,0,No,
1,4400,Elektronik,336,408,72,11,10,-1,21.43%,
1,4426,Kebutuhan Pokok,0,0,0,17,17,0,No,
1,4446,Snack,1860,1440,-420,3,4,1,No,
1,4447,Snack,810,810,0,59,59,0,No,
1,4449,Snack,510,510,0,2,2,0,No,
1,4451,Snack,0,0,0,9,9,0,No,
1,4459,Minuman,24,144,120,6,1,-5,500.00%,
1,4461,Minuman,0,24,24,8,0,-8,100.00%,Yes
1,4462,Minuman,120,216,96,16,9,-7,80.00%,
1,4467,Makanan & Susu Bayi,0,0,0,4,4,0,No,
1,4468,Makanan & Susu Bayi,24,24,0,24,24,0,No,
1,4471,Makanan & Susu Bayi,0,0,0,9,9,0,No,
1,4489,Makanan & Susu Bayi,36,36,0,11,11,0,No,
1,4490,Makanan & Susu Bayi,0,0,0,9,9,0,No,
1,4495,Obat-obatan,72,144,72,72,36,-36,100.00%,
1,4497,Obat-obatan,0,0,0,3,3,0,No,
1,4498,,36,72,36,77,39,-38,100.00%,
1,4516,Sarapan,0,0,0,10,10,0,No,
1,4529,Biskuit,24,48,24,110,55,-55,100.00%,
1,4533,Biskuit,96,156,60,41,26,-15,62.50%,
1,4540,Bahan Masak & Bumbu,0,24,24,3,0,-3,100.00%,Yes
1,4542,Bahan Masak & Bumbu,480,1320,840,193,71,-122,175.00%,
1,4586,Sarapan,0,0,0,33,33,0,No,
1,4589,Kebutuhan Pokok,12,12,0,4,4,0,No,
1,4618,Tepung & Bahan Kue,0,0,0,11,11,0,No,
1,4620,Kebutuhan Cuci Baju,2388,2130,-258,2,3,1,No,
1,4625,,132,150,18,92,81,-11,13.64%,
1,4639,Kebutuhan Dapur,444,384,-60,5,6,1,No,
1,4641,Kebersihan Badan,816,732,-84,3,4,1,No,
1,4655,Kebersihan Badan,0,24,24,34,0,-34,100.00%,Yes
1,4656,Kebersihan Badan,48,72,24,7,5,-2,50.00%,
1,4679,Obat-obatan,24,72,48,51,17,-34,200.00%,
1,4681,Perawatan Rumah,320,240,-80,3,4,1,No,
1,4692,,0,36,36,15,0,-15,100.00%,Yes
1,4708,Kebersihan Badan,0,0,0,7,7,0,No,
1,4736,Sarapan,0,60,60,63,0,-63,100.00%,Yes
1,4737,Biskuit,72,144,72,5,3,-2,100.00%,
1,4738,Biskuit,0,0,0,4,4,0,No,
1,4743,Permen,0,120,120,12,0,-12,100.00%,Yes
1,4746,Kebutuhan Pokok,0,0,0,3,3,0,No,
1,4786,,12,36,24,110,37,-73,200.00%,
1,4802,Bahan Masak & Bumbu,132,84,-48,166,261,95,No,
1,4818,Tepung & Bahan Kue,36,36,0,12,12,0,No,
1,4819,Tepung & Bahan Kue,0,0,0,53,53,0,No,
1,4872,Kebutuhan Pokok,0,0,0,27,27,0,No,
1,4876,Vitamin,48,24,-24,7,14,7,No,
1,4879,Snack,250,450,200,5,3,-2,80.00%,
1,4922,,0,0,0,149,149,0,No,
1,4942,Susu & Olahan Susu,0,0,0,133,133,0,No,
1,4943,Susu & Olahan Susu,0,0,0,189,189,0,No,
1,4945,Snack,216,216,0,23,23,0,No,
1,4958,Susu & Olahan Susu,0,0,0,203,203,0,No,
1,4987,Kebutuhan Ibu & Bayi,0,0,0,29,29,0,No,
1,5030,Bahan Masak & Bumbu,60,192,132,7,3,-4,220.00%,
1,5057,Susu & Olahan Susu,0,0,0,99,99,0,No,
1,5058,Susu & Olahan Susu,120,156,36,5,4,-1,30.00%,
1,5065,Obat-obatan,24,96,72,152,38,-114,300.00%,
1,5073,Make Up,48,60,12,38,31,-7,25.00%,
1,5074,Makanan & Susu Bayi,72,24,-48,6,18,12,No,
1,5075,Makanan & Susu Bayi,0,0,0,19,19,0,No,
1,5097,Bahan Masak & Bumbu,432,624,192,106,74,-32,44.44%,
1,5099,Obat-obatan,0,0,0,4,4,0,No,
1,5121,Bahan Masak & Bumbu,0,0,0,1,1,0,No,
1,5123,Susu & Olahan Susu,0,0,0,1,1,0,No,
1,5131,Snack,30,30,0,10,10,0,No,
1,5132,Snack,0,0,0,20,20,0,No,
1,5133,Snack,0,0,0,11,11,0,No,
1,5136,Kebutuhan Ibu & Bayi,0,0,0,2,2,0,No,
1,5163,,36,72,36,6,3,-3,100.00%,
1,5211,Bahan Masak & Bumbu,0,0,0,5,5,0,No,
1,5212,Bahan Masak & Bumbu,181,181,0,24,24,0,No,
1,5364,Snack,60,90,30,12,8,-4,50.00%,
1,5367,Snack,120,150,30,1,1,0,25.00%,
1,5368,Obat-obatan,0,0,0,17,17,0,No,
1,5419,Biskuit,0,0,0,31,31,0,No,
1,5421,Makanan & Susu Bayi,48,72,24,23,16,-7,50.00%,
1,5439,Perawatan Hewan,24,60,36,32,13,-19,150.00%,
1,5476,Sarapan,72,72,0,5,5,0,No,
1,5480,Cokelat,0,0,0,30,30,0,No,
1,5481,Snack,1650,1500,-150,87,96,9,No,
1,5504,Kebutuhan Cuci Baju,264,264,0,40,40,0,No,
1,5508,Perawatan Rumah,36,0,-36,2,2,0,No,
1,5542,Perawatan Mulut,0,0,0,1,1,0,No,
1,5545,Perawatan Diri ,24,24,0,47,47,0,No,
1,5610,Sarapan,0,0,0,13,13,0,No,
1,5613,Bahan Masak & Bumbu,324,288,-36,2,3,1,No,
1,5614,Bahan Masak & Bumbu,624,672,48,70,65,-5,7.69%,
1,5657,Sarapan,60,140,80,7,3,-4,133.33%,
1,5674,Susu & Olahan Susu,0,0,0,6,6,0,No,
1,5689,Bahan Masak & Bumbu,36,72,36,6,3,-3,100.00%,
1,5700,Snack,264,432,168,4,3,-1,63.64%,
1,5702,Kebutuhan Cuci Baju,3930,3570,-360,51,57,6,No,
1,5706,Bahan Masak & Bumbu,0,0,0,60,60,0,No,
1,5711,Kebutuhan Ibu & Bayi,0,0,0,2,2,0,No,
1,5731,Snack,0,0,0,96,96,0,No,
1,5748,Kebersihan Wajah,96,168,72,69,40,-29,75.00%,
1,5750,Kebersihan Wajah,0,0,0,15,15,0,No,
1,5778,Biskuit,0,90,90,1,0,-1,100.00%,Yes
1,5836,Snack,36,12,-24,3,9,6,No,
1,5857,Snack,852,636,-216,2,3,1,No,
1,5890,Alat Tulis Kantor,0,0,0,1,1,0,No,
1,5898,Makanan & Susu Bayi,84,84,0,17,17,0,No,
1,5909,Snack,92,46,-46,3,6,3,No,
1,5952,Minuman,0,0,0,1,1,0,No,
1,5959,Minuman,0,0,0,4,4,0,No,
1,5960,Minuman,0,0,0,14,14,0,No,
1,5973,Obat-obatan,0,0,0,11,11,0,No,
1,5983,Susu & Olahan Susu,96,96,0,3,3,0,No,
1,6009,Makanan & Susu Bayi,0,0,0,43,43,0,No,
1,6017,Makanan & Susu Bayi,0,0,0,6,6,0,No,
1,6018,Makanan & Susu Bayi,24,24,0,7,7,0,No,
1,6019,Makanan & Susu Bayi,0,0,0,2,2,0,No,
1,6022,Makanan & Susu Bayi,40,80,40,4,2,-2,100.00%,
1,6054,Vitamin,0,50,50,4,0,-4,100.00%,Yes
1,6131,Produk 21+,130,100,-30,1,2,1,No,
1,6176,Kebutuhan Cuci Baju,180,252,72,24,18,-6,40.00%,
1,6181,Minuman,0,0,0,3,3,0,No,
1,6187,Minuman,144,192,48,1,1,0,33.33%,
1,6188,Minuman,0,96,96,1,0,-1,100.00%,Yes
1,6189,Minuman,0,264,264,12,0,-12,100.00%,Yes
1,6199,Biskuit,520,960,440,52,29,-23,84.62%,
1,6200,Biskuit,36,792,756,117,6,-111,2100.00%,
1,6264,Snack,36,72,36,1,1,0,100.00%,
1,6285,Vitamin,0,0,0,36,36,0,No,
1,6296,Biskuit,80,80,0,18,18,0,No,
1,6359,Kebutuhan Cuci Baju,228,228,0,1,1,0,No,
1,6403,Perawatan Hewan,456,456,0,19,19,0,No,
1,6405,Perawatan Hewan,288,288,0,9,9,0,No,
1,6469,Perawatan Diri ,720,720,0,30,30,0,No,
1,6470,Perawatan Diri ,832,832,0,2,2,0,No,
1,6471,Perawatan Diri ,656,656,0,36,36,0,No,
1,6491,Susu & Olahan Susu,0,0,0,161,161,0,No,
1,6492,Susu & Olahan Susu,0,0,0,90,90,0,No,
1,6494,Susu & Olahan Susu,0,0,0,88,88,0,No,
1,6518,Bahan Masak & Bumbu,480,960,480,134,67,-67,100.00%,
1,6520,Bahan Masak & Bumbu,144,336,192,30,13,-17,133.33%,
1,6533,Susu & Olahan Susu,364,364,0,2,2,0,No,
1,6534,Susu & Olahan Susu,280,280,0,2,2,0,No,
1,6546,Kebutuhan Ibu & Bayi,176,176,0,2,2,0,No,
1,6547,Kebutuhan Ibu & Bayi,144,144,0,55,55,0,No,
1,6553,Snack,350,500,150,1,1,0,42.86%,
1,6561,Sarapan,108,198,90,15,9,-6,83.33%,
1,6566,Cokelat,0,0,0,5,5,0,No,
1,6567,Cokelat,0,0,0,4,4,0,No,
1,6570,Sarapan,0,0,0,2,2,0,No,
1,6573,Biskuit,80,80,0,7,7,0,No,
1,6578,Snack,1170,1170,0,42,42,0,No,
1,6582,Snack,240,360,120,26,18,-8,50.00%,
1,6587,Kebutuhan Ibu & Bayi,0,0,0,10,10,0,No,
1,6595,Makanan & Susu Bayi,12,12,0,6,6,0,No,
1,6608,Snack,0,0,0,6,6,0,No,
1,6649,Susu & Olahan Susu,0,216,216,42,0,-42,100.00%,Yes
1,6657,Sarapan,50,150,100,9,3,-6,200.00%,
1,6710,Susu & Olahan Susu,24,24,0,2,2,0,No,
1,6765,Bahan Masak & Bumbu,0,0,0,3,3,0,No,
1,6786,Perawatan Rumah,36,108,72,1,1,0,200.00%,
1,6807,Biskuit,0,24,24,35,0,-35,100.00%,Yes
1,6816,Snack,72,48,-24,57,86,29,No,
1,6846,Susu & Olahan Susu,0,0,0,91,91,0,No,
1,6871,Snack,0,0,0,14,14,0,No,
1,6872,Biskuit,0,72,72,2,0,-2,100.00%,Yes
1,6873,Biskuit,0,0,0,147,147,0,No,
1,6881,Kebutuhan Pokok,1224,1064,-160,8,10,2,No,
1,6898,Bahan Masak & Bumbu,288,0,-288,1,1,0,No,
1,6899,Bahan Masak & Bumbu,0,0,0,15,15,0,No,
1,6904,Tepung & Bahan Kue,160,0,-160,1,1,0,No,
1,6932,Skincare,0,0,0,14,14,0,No,
1,6933,Kebersihan Wajah,96,96,0,132,132,0,No,
1,6956,Susu & Olahan Susu,120,84,-36,2,3,1,No,
1,6963,Tepung & Bahan Kue,192,216,24,105,94,-11,12.50%,
1,6965,Kebutuhan Ibu & Bayi,124,108,-16,41,48,7,No,
1,6966,Kebutuhan Ibu & Bayi,44,36,-8,32,40,8,No,
1,6967,Kebutuhan Ibu & Bayi,228,228,0,35,35,0,No,
1,7058,Snack,0,0,0,4,4,0,No,
1,7068,Bahan Masak & Bumbu,456,1080,624,150,64,-86,136.84%,
1,7069,,0,0,0,6,6,0,No,
1,7072,Shampoo & Conditioner,168,120,-48,7,10,3,No,
1,7073,Shampoo & Conditioner,24,24,0,5,5,0,No,
1,7122,Gas & Air Galon,0,1202,1202,32,0,-32,100.00%,Yes
1,7124,Sarapan,60,180,120,168,56,-112,200.00%,
1,7153,Kebersihan Badan,24,36,12,8,6,-2,50.00%,
1,7272,Tepung & Bahan Kue,48,48,0,3,3,0,No,
1,7282,Biskuit,72,216,144,8,3,-5,200.00%,
1,7293,Bahan Masak & Bumbu,840,720,-120,8,10,2,No,
1,7469,Perawatan Rumah,84,96,12,68,60,-8,14.29%,
1,7609,Bahan Masak & Bumbu,0,0,0,32,32,0,No,
1,7782,Makanan & Susu Bayi,156,216,60,16,12,-4,38.46%,
1,7783,Minuman,0,48,48,1,0,-1,100.00%,Yes
1,7863,,930,1014,84,139,128,-11,9.03%,
1,7864,,1002,1098,96,142,130,-12,9.58%,
1,7942,Kebutuhan Cuci Baju,0,0,0,23,23,0,No,
1,7943,Kebutuhan Cuci Baju,102,102,0,41,41,0,No,
1,8227,Kebersihan Badan,96,96,0,27,27,0,No,
1,8234,Kebutuhan Pokok,6080,6080,0,129,129,0,No,
1,8291,Snack,0,24,24,7,0,-7,100.00%,Yes
1,8327,Sarapan,0,0,0,10,10,0,No,
1,8399,Kebersihan Badan,72,72,0,22,22,0,No,
1,8465,Snack,40,100,60,6,3,-3,150.00%,
1,8504,Kebersihan Badan,300,336,36,23,21,-2,12.00%,
1,8589,Minuman,0,0,0,2,2,0,No,
1,8711,Makanan & Susu Bayi,0,0,0,9,9,0,No,
1,8746,Snack,310,340,30,24,22,-2,9.68%,
1,8747,Snack,270,290,20,28,27,-1,7.41%,
1,8758,Susu & Olahan Susu,0,0,0,28,28,0,No,
1,8784,Makanan & Susu Bayi,0,0,0,18,18,0,No,
1,8791,Kebutuhan Ibu & Bayi,128,128,0,13,13,0,No,
1,8798,Shampoo & Conditioner,0,0,0,1,1,0,No,
1,8817,,60,60,0,13,13,0,No,
1,8860,Bahan Masak & Bumbu,40,30,-10,25,34,9,No,
1,8870,,0,0,0,119,119,0,No,
1,8896,Perlengkapan Pakaian ,0,12,12,7,0,-7,100.00%,Yes
1,8902,Bahan Masak & Bumbu,600,1416,816,60,26,-34,136.00%,
1,8930,Makanan & Susu Bayi,0,0,0,12,12,0,No,
1,8932,Makanan & Susu Bayi,0,0,0,13,13,0,No,
1,8969,Makanan & Susu Bayi,72,84,12,4,4,0,16.67%,
1,8976,Bahan Masak & Bumbu,0,0,0,1,1,0,No,
1,9085,Kebutuhan Ibu & Bayi,0,72,72,46,0,-46,100.00%,Yes
1,9124,,0,0,0,19,19,0,No,
1,9172,Kebutuhan Pokok,0,0,0,12,12,0,No,
1,9207,Kebutuhan Pokok,100,140,40,131,94,-37,40.00%,
1,9230,Perawatan Diri ,0,0,0,116,116,0,No,
1,9231,Perawatan Diri ,0,0,0,63,63,0,No,
1,9343,Biskuit,18,36,18,75,38,-37,100.00%,
1,9569,Alat Kesehatan,288,384,96,26,20,-6,33.33%,
1,9651,Alat Kesehatan,0,0,0,7,7,0,No,
1,9729,Biskuit,70,70,0,3,3,0,No,
1,9766,Perlengkapan Pesta,0,0,0,5,5,0,No,
1,9776,Perawatan Rumah,120,120,0,8,8,0,No,
1,9944,Kebutuhan Ibu & Bayi,24,24,0,1,1,0,No,
1,9945,Kebutuhan Ibu & Bayi,36,12,-24,2,6,4,No,
1,9949,Kebutuhan Ibu & Bayi,0,0,0,47,47,0,No,
1,9958,Perawatan Rumah,20,36,16,1,1,0,80.00%,
1,9959,Kebutuhan Cuci Baju,180,204,24,7,7,0,13.33%,
1,9960,Kebutuhan Cuci Baju,96,102,6,11,11,0,6.25%,
1,9961,Perawatan Rumah,264,264,0,2,2,0,No,
1,10061,Perawatan Rumah,0,0,0,23,23,0,No,
1,10230,Perawatan Mulut,0,0,0,3,3,0,No,
1,10280,Bahan Masak & Bumbu,48,0,-48,1,1,0,No,
1,10295,Kebersihan Badan,222,191,-31,20,24,4,No,
1,10348,Biskuit,12,24,12,19,10,-9,100.00%,
1,10356,Kebersihan Badan,168,192,24,4,4,0,14.29%,
1,10357,Kebersihan Badan,72,84,12,17,15,-2,16.67%,
1,10384,Alat Kesehatan,0,0,0,8,8,0,No,
1,10410,Perawatan Mulut,48,48,0,6,6,0,No,
1,10481,Bahan Masak & Bumbu,0,0,0,2,2,0,No,
1,10601,Kebersihan Badan,24,36,12,5,4,-1,50.00%,
1,10620,Vitamin,0,0,0,4,4,0,No,
1,10733,Shampoo & Conditioner,49,49,0,8,8,0,No,
1,10758,Perawatan Hewan,24,60,36,1,1,0,150.00%,
1,10832,Kebutuhan Ibu & Bayi,132,120,-12,2,3,1,No,
1,10833,Kebutuhan Ibu & Bayi,96,48,-48,1,2,1,No,
1,10854,Kebutuhan Ibu & Bayi,60,48,-12,2,3,1,No,
1,10858,Kebutuhan Ibu & Bayi,84,72,-12,4,5,1,No,
1,10868,Sarapan,0,0,0,35,35,0,No,
1,10894,Vitamin,0,0,0,3,3,0,No,
1,10895,Vitamin,0,0,0,1,1,0,No,
1,10911,Sarapan,48,24,-24,1,2,1,No,
1,10912,Minuman,0,0,0,68,68,0,No,
1,10934,Sarapan,240,240,0,82,82,0,No,
1,10951,Kebutuhan Ibu & Bayi,0,0,0,120,120,0,No,
1,10965,Kebutuhan Ibu & Bayi,25,0,-25,27,27,0,No,
1,10966,Kebutuhan Ibu & Bayi,46,46,0,3,3,0,No,
1,10970,Perawatan Hewan,480,480,0,28,28,0,No,
1,11263,Perawatan Diri ,0,0,0,37,37,0,No,
1,11265,Kebutuhan Cuci Baju,60,48,-12,2,3,1,No,
1,11269,,186,204,18,47,43,-4,9.68%,
1,11278,Kebutuhan Cuci Baju,0,0,0,15,15,0,No,
1,11279,Kebutuhan Cuci Baju,162,132,-30,2,3,1,No,
1,11320,Minuman,24,48,24,1,1,0,100.00%,
1,11328,Minuman,72,96,24,109,82,-27,33.33%,
1,11368,Snack,75,125,50,20,12,-8,66.67%,
1,11385,Kebutuhan Dapur,60,48,-12,4,5,1,No,
1,11398,Kebutuhan Dapur,0,0,0,31,31,0,No,
1,11401,Bahan Masak & Bumbu,0,0,0,109,109,0,No,
1,11405,Bahan Masak & Bumbu,0,240,240,172,0,-172,100.00%,Yes
1,11433,Kebutuhan Ibu & Bayi,88,108,20,13,11,-2,22.73%,
1,11434,Kebutuhan Ibu & Bayi,0,0,0,28,28,0,No,
1,11441,Kebutuhan Ibu & Bayi,96,96,0,52,52,0,No,
1,11442,Kebutuhan Ibu & Bayi,4,4,0,20,20,0,No,
1,11467,Snack,40,0,-40,1,1,0,No,
1,11481,Perawatan Hewan,192,192,0,3,3,0,No,
1,11486,Perawatan Hewan,36,36,0,4,4,0,No,
1,11488,Perawatan Hewan,0,0,0,56,56,0,No,
1,11497,Skincare,15,15,0,5,5,0,No,
1,11507,Kebutuhan Ibu & Bayi,24,24,0,9,9,0,No,
1,11540,Minuman,0,0,0,2,2,0,No,
1,11582,Kebutuhan Pokok,12,12,0,9,9,0,No,
1,11584,Kebutuhan Cuci Baju,366,324,-42,24,28,4,No,
1,11589,Kebutuhan Cuci Baju,0,0,0,6,6,0,No,
1,11591,Kebutuhan Cuci Baju,192,156,-36,20,25,5,No,
1,11598,,120,132,12,57,52,-5,10.00%,
1,11603,Kebutuhan Cuci Baju,540,480,-60,39,44,5,No,
1,11606,Kebutuhan Cuci Baju,240,276,36,33,29,-4,15.00%,
1,11612,Kebutuhan Cuci Baju,24,12,-12,10,20,10,No,
1,11614,Kebutuhan Cuci Baju,12,0,-12,5,5,0,No,
1,11617,Kebutuhan Cuci Baju,228,204,-24,10,12,2,No,
1,11618,Kebutuhan Cuci Baju,0,0,0,1,1,0,No,
1,11620,Kebutuhan Cuci Baju,36,36,0,2,2,0,No,
1,11748,Shampoo & Conditioner,96,72,-24,44,59,15,No,
1,11749,Kebutuhan Ibu & Bayi,588,588,0,29,29,0,No,
1,11779,Kebutuhan Cuci Baju,192,216,24,26,24,-2,12.50%,
1,11783,Kebutuhan Cuci Baju,0,0,0,17,17,0,No,
1,11784,Kebutuhan Cuci Baju,84,96,12,5,5,0,14.29%,
1,11786,Kebutuhan Cuci Baju,12,12,0,4,4,0,No,
1,11789,Kebutuhan Cuci Baju,108,126,18,10,9,-1,16.67%,
1,11790,Kebutuhan Cuci Baju,168,192,24,73,64,-9,14.29%,
1,11867,Vitamin,25,25,0,7,7,0,No,
1,11871,Sarapan,0,0,0,17,17,0,No,
1,11934,Tepung & Bahan Kue,0,0,0,1,1,0,No,
1,11961,Bahan Masak & Bumbu,0,0,0,15,15,0,No,
1,11966,Bahan Masak & Bumbu,0,84,84,8,0,-8,100.00%,Yes
1,11967,Bahan Masak & Bumbu,0,240,240,62,0,-62,100.00%,Yes
1,11969,Bahan Masak & Bumbu,0,0,0,22,22,0,No,
1,11971,Bahan Masak & Bumbu,0,83,83,26,0,-26,100.00%,Yes
1,11993,Bahan Masak & Bumbu,0,0,0,30,30,0,No,
1,12006,Kebutuhan Pokok,0,0,0,6,6,0,No,
1,12008,Tepung & Bahan Kue,0,0,0,1,1,0,No,
1,12073,Snack,0,0,0,19,19,0,No,
1,12074,Snack,24,24,0,2,2,0,No,
1,12124,Perawatan Diri ,126,126,0,23,23,0,No,
1,12147,Bahan Masak & Bumbu,120,168,48,112,80,-32,40.00%,
1,12216,Alat Kesehatan,0,0,0,1,1,0,No,
1,12217,Alat Kesehatan,0,0,0,4,4,0,No,
1,12259,Biskuit,0,0,0,3,3,0,No,
1,12307,Biskuit,144,144,0,15,15,0,No,
1,12308,Biskuit,64,64,0,7,7,0,No,
1,12337,Biskuit,0,0,0,12,12,0,No,
1,12338,Biskuit,0,0,0,6,6,0,No,
1,12451,Kebersihan Wajah,0,24,24,27,0,-27,100.00%,Yes
1,12452,Make Up,0,0,0,11,11,0,No,
1,12508,Perawatan Mulut,48,48,0,29,29,0,No,
1,12553,Obat-obatan,0,0,0,51,51,0,No,
1,12640,Snack,0,0,0,88,88,0,No,
1,12657,Makanan & Susu Bayi,0,0,0,1,1,0,No,
1,12725,Shampoo & Conditioner,0,0,0,15,15,0,No,
1,12736,Perawatan Rumah,0,0,0,26,26,0,No,
1,12750,Perawatan Rumah,132,120,-12,3,4,1,No,
1,12832,Perawatan Mulut,0,0,0,80,80,0,No,
1,12860,Snack,0,0,0,1,1,0,No,
1,12862,Snack,0,0,0,40,40,0,No,
1,12867,Snack,0,0,0,2,2,0,No,
1,12883,Sarapan,0,0,0,6,6,0,No,
1,12897,,0,12,12,20,0,-20,100.00%,Yes
1,12935,Susu & Olahan Susu,48,48,0,34,34,0,No,
1,12945,Tepung & Bahan Kue,20,20,0,29,29,0,No,
1,12969,Kebersihan Badan,132,132,0,80,80,0,No,
1,12970,Kebersihan Badan,132,132,0,105,105,0,No,
1,13110,Kebersihan Badan,36,36,0,2,2,0,No,
1,13251,Snack,38,38,0,54,54,0,No,
1,13253,,185,172,-13,71,77,6,No,
1,13255,Snack,0,0,0,21,21,0,No,
1,13257,,37,0,-37,4,4,0,No,
1,13316,Kebutuhan Pokok,171,171,0,16,16,0,No,
1,13343,Kebersihan Badan,40,40,0,8,8,0,No,
1,13446,Biskuit,0,0,0,7,7,0,No,
1,13479,Perawatan Rumah,0,0,0,2,2,0,No,
1,13570,Sarapan,84,60,-24,17,24,7,No,
1,13648,Sarapan,12,12,0,18,18,0,No,
1,13771,Skincare,0,0,0,11,11,0,No,
1,13877,Perawatan Diri ,32,32,0,6,6,0,No,
1,13902,Perawatan Rumah,12,24,12,33,17,-16,100.00%,
1,13903,Perawatan Rumah,84,84,0,83,83,0,No,
1,13904,Perawatan Rumah,324,192,-132,74,125,51,No,
1,13997,Shampoo & Conditioner,0,0,0,16,16,0,No,
1,14057,Shampoo & Conditioner,135,148,13,11,11,0,9.63%,
1,14239,Perawatan Rumah,72,72,0,75,75,0,No,
1,14375,Perawatan Hewan,0,24,24,3,0,-3,100.00%,Yes
1,14381,Biskuit,0,0,0,1,1,0,No,
1,14405,Perawatan Mulut,96,96,0,2,2,0,No,
1,14416,Perawatan Mulut,0,0,0,4,4,0,No,
1,14417,Perawatan Mulut,48,48,0,27,27,0,No,
1,14437,Cokelat,0,0,0,1,1,0,No,
1,14441,Cokelat,0,0,0,34,34,0,No,
1,14444,Cokelat,0,0,0,184,184,0,No,
1,14460,Snack,960,504,-456,1,2,1,No,
1,14479,Kebutuhan Pokok,0,0,0,15,15,0,No,
1,14483,Kebutuhan Pokok,0,0,0,16,16,0,No,
1,14484,Kebutuhan Pokok,40,40,0,21,21,0,No,
1,14488,Kebersihan Badan,360,324,-36,12,14,2,No,
1,14493,Perlengkapan Pakaian ,48,48,0,11,11,0,No,
1,14494,Perlengkapan Pakaian ,0,0,0,26,26,0,No,
1,14536,Minuman,0,0,0,40,40,0,No,
1,14538,Minuman,0,0,0,16,16,0,No,
1,14539,Minuman,72,24,-48,5,15,10,No,
1,14544,Minuman,0,0,0,16,16,0,No,
1,14552,Bahan Masak & Bumbu,0,0,0,17,17,0,No,
1,14595,Perawatan Mulut,0,48,48,5,0,-5,100.00%,Yes
1,14691,Alat Kesehatan,150,200,50,100,75,-25,33.33%,
1,14768,Biskuit,10,0,-10,11,11,0,No,
1,14809,Minuman,72,96,24,62,47,-15,33.33%,
1,14812,Kebutuhan Pokok,0,0,0,53,53,0,No,
1,14825,Minuman,0,120,120,4,0,-4,100.00%,Yes
1,14859,Biskuit,320,320,0,1,1,0,No,
1,14898,Kebutuhan Pokok,750,1110,360,9,7,-2,48.00%,
1,14905,Bahan Masak & Bumbu,64,64,0,5,5,0,No,
1,14943,Perawatan Rumah,93,40,-53,1,3,2,No,
1,14994,Shampoo & Conditioner,0,0,0,5,5,0,No,
1,15008,,7,9,2,5,4,-1,28.57%,
1,15010,,48,46,-2,1,2,1,No,
1,15028,Tepung & Bahan Kue,48,168,120,146,42,-104,250.00%,
1,15048,Kebersihan Wajah,0,0,0,1,1,0,No,
1,15075,Kebutuhan Cuci Baju,378,378,0,69,69,0,No,
1,15077,Kebutuhan Cuci Baju,468,468,0,52,52,0,No,
1,15118,Kebutuhan Cuci Baju,390,330,-60,1,2,1,No,
1,15130,Perawatan Diri ,0,0,0,56,56,0,No,
1,15146,Perawatan Diri ,48,48,0,3,3,0,No,
1,15188,Permen,36,108,72,6,2,-4,200.00%,
1,15310,Minuman,0,0,0,61,61,0,No,
1,15366,Kebutuhan Ibu & Bayi,96,72,-24,24,32,8,No,
1,15369,Kebutuhan Ibu & Bayi,144,120,-24,56,68,12,No,
1,15371,Kebutuhan Ibu & Bayi,348,396,48,22,20,-2,13.79%,
1,15509,Tata Rumah,10,30,20,11,4,-7,200.00%,
1,15512,Perawatan Rumah,0,66,66,1,0,-1,100.00%,Yes
1,15554,Kebutuhan Pokok,48,48,0,12,12,0,No,
1,15569,,24,24,0,7,7,0,No,
1,15624,Bahan Masak & Bumbu,1032,1128,96,85,78,-7,9.30%,
1,15633,Bahan Masak & Bumbu,0,0,0,26,26,0,No,
1,15641,Kebutuhan Pokok,468,468,0,1,1,0,No,
1,15826,Kebutuhan Cuci Baju,12,12,0,5,5,0,No,
1,15832,Kebutuhan Pokok,120,120,0,60,60,0,No,
1,15835,Kebutuhan Pokok,40,40,0,3,3,0,No,
1,15917,Sarapan,0,0,0,8,8,0,No,
1,15953,Kebutuhan Cuci Baju,352,312,-40,13,15,2,No,
1,15954,Kebutuhan Cuci Baju,156,132,-24,8,10,2,No,
1,16120,Cokelat,0,0,0,7,7,0,No,
1,16156,Perawatan Rumah,0,0,0,56,56,0,No,
1,16157,Perawatan Rumah,24,24,0,48,48,0,No,
1,16169,Perawatan Rumah,0,0,0,65,65,0,No,
1,16441,Biskuit,48,48,0,12,12,0,No,
1,16473,Kebersihan Wajah,96,72,-24,3,4,1,No,
1,16518,Kebersihan Badan,132,120,-12,5,6,1,No,
1,16520,Kebersihan Badan,1152,1044,-108,3,4,1,No,
1,16540,Kebersihan Badan,0,0,0,21,21,0,No,
1,16587,Bahan Masak & Bumbu,48,144,96,1,1,0,200.00%,
1,16645,Permen,0,0,0,7,7,0,No,
1,16759,Kebutuhan Ibu & Bayi,96,84,-12,17,20,3,No,
1,16867,Snack,180,240,60,42,32,-10,33.33%,
1,16885,Snack,132,132,0,5,5,0,No,
1,16990,Obat-obatan,0,0,0,4,4,0,No,
1,17258,Minuman,0,0,0,18,18,0,No,
1,17290,Perawatan Rumah,0,0,0,14,14,0,No,
1,17342,Perawatan Rumah,0,0,0,1,1,0,No,
1,17361,Makanan & Susu Bayi,40,40,0,6,6,0,No,
1,17433,Gas & Air Galon,12,56,44,6,2,-4,366.67%,
1,17470,Susu & Olahan Susu,252,324,72,38,30,-8,28.57%,
1,17514,Susu & Olahan Susu,0,96,96,166,0,-166,100.00%,Yes
1,17593,Bahan Masak & Bumbu,0,0,0,28,28,0,No,
1,17616,Kebutuhan Ibu & Bayi,48,48,0,9,9,0,No,
1,17662,Bahan Masak & Bumbu,0,0,0,24,24,0,No,
1,17725,Perlengkapan Pakaian ,432,408,-24,27,29,2,No,
1,17732,Perlengkapan Pakaian ,504,456,-48,59,66,7,No,
1,17768,Kebutuhan Pokok,80,80,0,154,154,0,No,
1,17770,Snack,48,72,24,5,4,-1,50.00%,
1,17772,Snack,72,120,48,7,5,-2,66.67%,
1,17773,Kebutuhan Pokok,80,80,0,120,120,0,No,
1,17780,Kebutuhan Pokok,80,80,0,173,173,0,No,
1,17809,Biskuit,48,48,0,88,88,0,No,
1,17906,,492,492,0,11,11,0,No,
1,17907,Snack,144,168,24,6,6,0,16.67%,
1,17916,Snack,144,120,-24,16,20,4,No,
1,17969,Kebersihan Badan,558,558,0,24,24,0,No,
1,17990,Kebersihan Badan,96,72,-24,1,2,1,No,
1,17991,Kebersihan Badan,288,192,-96,1,2,1,No,
1,18009,Kebersihan Wajah,48,48,0,72,72,0,No,
1,18081,Kebutuhan Pokok,0,0,0,45,45,0,No,
1,18118,Perawatan Diri ,0,0,0,14,14,0,No,
1,18132,Perawatan Diri ,12,12,0,3,3,0,No,
1,18167,Kebutuhan Cuci Baju,108,126,18,48,42,-6,16.67%,
1,18169,Kebutuhan Cuci Baju,24,36,12,9,6,-3,50.00%,
1,18172,Kebutuhan Cuci Baju,84,96,12,22,20,-2,14.29%,
1,18174,Kebutuhan Cuci Baju,228,192,-36,25,30,5,No,
1,18178,Kebutuhan Cuci Baju,6,0,-6,16,16,0,No,
1,18183,Kebutuhan Cuci Baju,60,42,-18,21,30,9,No,
1,18186,Kebutuhan Cuci Baju,0,0,0,54,54,0,No,
1,18200,Biskuit,0,0,0,15,15,0,No,
1,18215,Obat-obatan,48,36,-12,7,10,3,No,
1,18401,Susu & Olahan Susu,36,36,0,58,58,0,No,
1,18479,Cokelat,0,0,0,4,4,0,No,
1,18542,Kebutuhan Pokok,780,1070,290,16,12,-4,37.18%,
1,18555,Kebutuhan Cuci Baju,144,132,-12,31,34,3,No,
1,18580,Makanan & Susu Bayi,0,0,0,3,3,0,No,
1,18761,Perawatan Diri ,36,36,0,38,38,0,No,
1,18817,Minuman,0,0,0,6,6,0,No,
1,18895,Skincare,216,144,-72,1,2,1,No,
1,18906,Bahan Masak & Bumbu,312,384,72,1,1,0,23.08%,
1,19026,Kebersihan Badan,0,48,48,47,0,-47,100.00%,Yes
1,19062,Shampoo & Conditioner,12,12,0,3,3,0,No,
1,19085,Kebutuhan Cuci Baju,0,0,0,4,4,0,No,
1,19088,Kebutuhan Cuci Baju,0,0,0,8,8,0,No,
1,19098,Kebutuhan Cuci Baju,0,0,0,31,31,0,No,
1,19105,Kebutuhan Cuci Baju,0,0,0,12,12,0,No,
1,19240,Makanan & Susu Bayi,0,0,0,16,16,0,No,
1,19449,Perawatan Rumah,0,0,0,1,1,0,No,
1,19517,Obat-obatan,0,0,0,48,48,0,No,
1,19574,Kebutuhan Pokok,0,0,0,10,10,0,No,
1,19719,Bahan Masak & Bumbu,96,84,-12,4,5,1,No,
1,19721,Bahan Masak & Bumbu,0,0,0,71,71,0,No,
1,19727,Bahan Masak & Bumbu,0,0,0,10,10,0,No,
1,19788,Kebutuhan Pokok,560,680,120,9,8,-1,21.43%,
1,19810,Perawatan Diri ,0,0,0,69,69,0,No,
1,19830,Kebutuhan Pokok,12,24,12,52,26,-26,100.00%,
1,19901,Bahan Masak & Bumbu,12,60,48,35,7,-28,400.00%,
1,19952,Vitamin,0,0,0,9,9,0,No,
1,19973,Kebutuhan Pokok,252,168,-84,1,2,1,No,
1,19985,Kebutuhan Pokok,216,180,-36,5,6,1,No,
1,19987,Kebutuhan Pokok,3828,4164,336,7,7,0,8.78%,
1,20065,Perawatan Mulut,144,144,0,2,2,0,No,
1,20087,Shampoo & Conditioner,96,84,-12,8,10,2,No,
1,20088,Shampoo & Conditioner,216,192,-24,2,3,1,No,
1,20280,Perawatan Hewan,552,672,120,19,16,-3,21.74%,
1,20317,Perawatan Rumah,144,162,18,15,14,-1,12.50%,
1,20321,Perawatan Rumah,204,228,24,5,5,0,11.76%,
1,20423,Permen,24,24,0,1,1,0,No,
1,20482,Perawatan Rumah,24,36,12,1,1,0,50.00%,
1,20561,Kebutuhan Ibu & Bayi,12,0,-12,4,4,0,No,
1,20629,,48,60,12,133,107,-26,25.00%,
1,20632,Skincare,24,0,-24,1,1,0,No,
1,20692,Permen,30,60,30,60,30,-30,100.00%,
1,20704,Perawatan Hewan,12,24,12,13,7,-6,100.00%,
1,20710,Permen,0,0,0,7,7,0,No,
1,20719,Perawatan Mulut,1608,1464,-144,23,26,3,No,
1,20726,Snack,0,0,0,2,2,0,No,
1,20727,Snack,0,0,0,4,4,0,No,
1,20740,Perawatan Rumah,0,0,0,3,3,0,No,
1,20904,Sarapan,48,48,0,19,19,0,No,
1,20926,Perawatan Rumah,18,12,-6,5,8,3,No,
1,20928,Perawatan Rumah,0,0,0,43,43,0,No,
1,20929,Perawatan Rumah,0,0,0,10,10,0,No,
1,20931,Perawatan Rumah,120,96,-24,3,4,1,No,
1,20951,Sarapan,0,0,0,81,81,0,No,
1,20957,Sarapan,0,48,48,112,0,-112,100.00%,Yes
1,21010,Perawatan Rumah,36,36,0,6,6,0,No,
1,21011,Perawatan Rumah,72,72,0,8,8,0,No,
1,21351,Kebutuhan Cuci Baju,474,396,-78,35,42,7,No,
1,21352,Kebutuhan Cuci Baju,270,204,-66,1,2,1,No,
1,21401,Perawatan Diri ,0,0,0,202,202,0,No,
1,21442,Susu & Olahan Susu,12,24,12,42,21,-21,100.00%,
1,21446,Susu & Olahan Susu,0,0,0,113,113,0,No,
1,21447,Susu & Olahan Susu,36,36,0,5,5,0,No,
1,21458,Makanan & Susu Bayi,0,0,0,1,1,0,No,
1,21774,Perawatan Diri ,72,84,12,16,14,-2,16.67%,
1,21839,Obat-obatan,0,0,0,106,106,0,No,
1,21898,Snack,150,150,0,26,26,0,No,
1,21899,Snack,96,192,96,3,2,-1,100.00%,
1,21901,Snack,0,0,0,52,52,0,No,
1,21902,Snack,100,100,0,31,31,0,No,
1,22033,Bahan Masak & Bumbu,24,48,24,20,10,-10,100.00%,
1,22363,,30,30,0,7,7,0,No,
1,22385,Alat Kesehatan,12,12,0,6,6,0,No,
1,22421,Susu & Olahan Susu,792,792,0,10,10,0,No,
1,22437,Kebutuhan Cuci Baju,0,0,0,11,11,0,No,
1,22578,Shampoo & Conditioner,24,24,0,16,16,0,No,
1,22581,Makanan & Susu Bayi,120,48,-72,2,5,3,No,
1,22704,Fashion Aksesoris,0,0,0,9,9,0,No,
1,22732,Biskuit,264,408,144,13,9,-4,54.55%,
1,22737,Makanan & Susu Bayi,96,120,24,5,4,-1,25.00%,
1,22777,Snack,150,100,-50,1,2,1,No,
1,22882,Biskuit,18,18,0,17,17,0,No,
1,22886,Kebutuhan Dapur,588,648,60,69,63,-6,10.20%,
1,22927,Snack,1080,990,-90,1,2,1,No,
1,22933,Sarapan,156,156,0,109,109,0,No,
1,22973,Vitamin,18,18,0,5,5,0,No,
1,23148,Kebutuhan Ibu & Bayi,216,240,24,1,1,0,11.11%,
1,23152,Snack,12,36,24,7,3,-4,200.00%,
1,23357,Kebersihan Badan,240,192,-48,12,15,3,No,
1,23455,Perawatan Rumah,1368,1176,-192,14,17,3,No,
1,23567,Alat Tulis Kantor,0,0,0,2,2,0,No,
1,23710,Snack,24,60,36,16,7,-9,150.00%,
1,23711,Snack,0,24,24,13,0,-13,100.00%,Yes
1,23717,Kebutuhan Pokok,0,0,0,1,1,0,No,
1,23924,Perawatan Mulut,0,0,0,17,17,0,No,
1,23991,Snack,0,0,0,1,1,0,No,
1,24046,Fashion Aksesoris,0,0,0,4,4,0,No,
1,24056,,636,660,24,102,99,-3,3.77%,
1,24057,Snack,48,96,48,3,2,-1,100.00%,
1,24117,Susu & Olahan Susu,168,120,-48,1,2,1,No,
1,24118,Susu & Olahan Susu,2198,2480,282,11,10,-1,12.83%,
1,24128,Kebutuhan Cuci Baju,540,594,54,54,50,-4,10.00%,
1,24180,Perawatan Hewan,0,0,0,63,63,0,No,
1,24183,Perawatan Hewan,108,108,0,8,8,0,No,
1,24184,Perawatan Hewan,396,450,54,64,57,-7,13.64%,
1,24211,Perawatan Hewan,144,144,0,15,15,0,No,
1,24446,Perawatan Hewan,108,108,0,10,10,0,No,
1,24512,Kebutuhan Pokok,0,0,0,13,13,0,No,
1,24559,Cokelat,0,0,0,87,87,0,No,
1,24575,Perawatan Rumah,0,0,0,4,4,0,No,
1,24716,Makanan & Susu Bayi,288,0,-288,1,1,0,No,
1,24911,Kebutuhan Ibu & Bayi,0,0,0,6,6,0,No,
1,24958,Perlengkapan Pesta,0,0,0,2,2,0,No,
1,25108,Kebutuhan Cuci Baju,84,96,12,31,28,-3,14.29%,
1,25110,Perawatan Rumah,0,0,0,2,2,0,No,
1,25112,Perawatan Rumah,432,384,-48,36,41,5,No,
1,25115,,12,12,0,4,4,0,No,
1,25123,,72,84,12,79,68,-11,16.67%,
1,25130,Kebutuhan Cuci Baju,0,12,12,35,0,-35,100.00%,Yes
1,25144,Snack,48,48,0,2,2,0,No,
1,25145,Kebutuhan Pokok,88,104,16,68,58,-10,18.18%,
1,25221,Kebutuhan Cuci Baju,450,450,0,58,58,0,No,
1,25273,Snack,0,0,0,7,7,0,No,
1,25275,Snack,0,0,0,13,13,0,No,
1,25276,Snack,64,64,0,43,43,0,No,
1,25278,,36,36,0,1,1,0,No,
1,25329,Bahan Masak & Bumbu,20,0,-20,12,12,0,No,
1,25356,Perawatan Mulut,96,96,0,9,9,0,No,
1,25372,,60,60,0,7,7,0,No,
1,25373,Shampoo & Conditioner,12,12,0,10,10,0,No,
1,25378,Perawatan Mulut,120,96,-24,9,12,3,No,
1,25381,Kebersihan Badan,144,144,0,10,10,0,No,
1,25385,Skincare,48,48,0,10,10,0,No,
1,25390,Kebersihan Wajah,15,15,0,9,9,0,No,
1,25431,Kebutuhan Ibu & Bayi,0,0,0,14,14,0,No,
1,25471,Make Up,24,24,0,45,45,0,No,
1,25502,Obat-obatan,84,120,36,4,3,-1,42.86%,
1,25505,Obat-obatan,0,0,0,7,7,0,No,
1,25520,Perawatan Hewan,0,0,0,66,66,0,No,
1,25525,Perawatan Hewan,12,12,0,12,12,0,No,
1,25526,Perawatan Hewan,120,120,0,30,30,0,No,
1,25528,Perawatan Hewan,72,72,0,22,22,0,No,
1,25535,Perawatan Hewan,0,0,0,39,39,0,No,
1,25537,Perawatan Hewan,0,0,0,5,5,0,No,
1,25538,Perawatan Hewan,48,48,0,45,45,0,No,
1,25541,Perawatan Hewan,96,120,24,9,8,-1,25.00%,
1,25551,,105,120,15,1,1,0,14.29%,
1,25554,Kebutuhan Ibu & Bayi,0,0,0,4,4,0,No,
1,25581,Kebutuhan Ibu & Bayi,60,60,0,2,2,0,No,
1,25617,Alat Kesehatan,0,0,0,2,2,0,No,
1,25650,Perawatan Mulut,84,84,0,2,2,0,No,
1,25668,Tata Rumah,300,300,0,78,78,0,No,
1,25674,Perawatan Rumah,0,0,0,98,98,0,No,
1,25681,Perawatan Rumah,105,105,0,9,9,0,No,
1,25689,Kebutuhan Dapur,72,60,-12,3,4,1,No,
1,25690,Kebutuhan Cuci Baju,0,0,0,1,1,0,No,
1,25691,Kebutuhan Cuci Baju,36,0,-36,27,27,0,No,
1,25693,Kebutuhan Dapur,204,174,-30,3,4,1,No,
1,25694,Kebutuhan Dapur,300,240,-60,2,3,1,No,
1,25717,Kebutuhan Pokok,0,0,0,10,10,0,No,
1,25743,Perawatan Rumah,0,0,0,50,50,0,No,
1,25787,Obat-obatan,0,0,0,28,28,0,No,
1,25846,Kebutuhan Cuci Baju,0,0,0,58,58,0,No,
1,25894,Perawatan Rumah,500,0,-500,11,11,0,No,
1,25895,Perawatan Rumah,200,0,-200,1,1,0,No,
1,26099,,0,16,16,46,0,-46,100.00%,Yes
1,26101,,68,102,34,80,54,-26,50.00%,
1,26106,,68,68,0,27,27,0,No,
1,26125,Kebutuhan Pokok,0,0,0,39,39,0,No,
1,26128,Vitamin,0,0,0,3,3,0,No,
1,26134,Sarapan,60,60,0,35,35,0,No,
1,26135,Sarapan,0,0,0,38,38,0,No,
1,26136,Sarapan,0,0,0,17,17,0,No,
1,26137,Biskuit,36,72,36,16,8,-8,100.00%,
1,26261,Tepung & Bahan Kue,0,0,0,77,77,0,No,
1,26306,Kebutuhan Cuci Baju,24,24,0,3,3,0,No,
1,26307,Kebutuhan Cuci Baju,0,0,0,12,12,0,No,
1,26309,Kebutuhan Cuci Baju,24,24,0,32,32,0,No,
1,26310,,228,228,0,105,105,0,No,
1,26318,Perawatan Diri ,84,84,0,50,50,0,No,
1,26319,Perawatan Diri ,252,216,-36,1,2,1,No,
1,26374,Kebersihan Badan,0,0,0,3,3,0,No,
1,26383,Makanan & Susu Bayi,0,0,0,4,4,0,No,
1,26400,Makanan & Susu Bayi,0,0,0,6,6,0,No,
1,26420,Makanan & Susu Bayi,0,0,0,12,12,0,No,
1,26421,Makanan & Susu Bayi,0,0,0,2,2,0,No,
1,26464,,200,200,0,28,28,0,No,
1,26474,Susu & Olahan Susu,0,0,0,21,21,0,No,
1,26514,Kebutuhan Cuci Baju,231,123,-108,18,34,16,No,
1,26518,Kebutuhan Dapur,42,48,6,7,7,0,14.29%,
1,26519,Perawatan Rumah,66,39,-27,40,68,28,No,
1,26520,Perawatan Rumah,0,0,0,47,47,0,No,
1,26528,Kebutuhan Cuci Baju,60,36,-24,7,12,5,No,
1,26529,Kebutuhan Cuci Baju,72,72,0,40,40,0,No,
1,26543,Alat Kesehatan,0,0,0,56,56,0,No,
1,26837,Bahan Masak & Bumbu,0,0,0,1,1,0,No,
1,26849,Shampoo & Conditioner,0,0,0,9,9,0,No,
1,26850,Shampoo & Conditioner,36,36,0,5,5,0,No,
1,26858,Perawatan Diri ,336,288,-48,1,2,1,No,
1,26859,Tepung & Bahan Kue,0,0,0,4,4,0,No,
1,26945,Makanan & Susu Bayi,0,24,24,12,0,-12,100.00%,Yes
1,26948,Makanan & Susu Bayi,0,0,0,38,38,0,No,
1,26952,Perawatan Diri ,120,120,0,27,27,0,No,
1,26956,Perawatan Diri ,0,0,0,50,50,0,No,
1,26966,Kebutuhan Pokok,0,0,0,50,50,0,No,
1,27163,Permen,0,240,240,2,0,-2,100.00%,Yes
1,27166,Permen,0,0,0,2,2,0,No,
1,27167,Alat Kesehatan,24,24,0,4,4,0,No,
1,27168,Alat Kesehatan,0,0,0,6,6,0,No,
1,27205,Kebutuhan Ibu & Bayi,138,138,0,37,37,0,No,
1,27206,Kebutuhan Ibu & Bayi,594,594,0,35,35,0,No,
1,27214,Snack,10,10,0,1,1,0,No,
1,27254,Sarapan,60,60,0,1,1,0,No,
1,27550,Kebersihan Wajah,0,0,0,1,1,0,No,
1,27616,Perawatan Rumah,420,372,-48,76,86,10,No,
1,27665,Perawatan Hewan,120,120,0,42,42,0,No,
1,27671,Perawatan Hewan,72,72,0,18,18,0,No,
1,27672,Vitamin,0,24,24,89,0,-89,100.00%,Yes
1,27682,Vitamin,0,0,0,45,45,0,No,
1,27733,Elektronik,0,0,0,24,24,0,No,
1,27978,Makanan & Susu Bayi,0,48,48,55,0,-55,100.00%,Yes
1,27979,Makanan & Susu Bayi,48,48,0,25,25,0,No,
1,27980,Makanan & Susu Bayi,0,0,0,8,8,0,No,
1,27981,Makanan & Susu Bayi,0,0,0,13,13,0,No,
1,28083,Make Up,0,0,0,24,24,0,No,
1,28084,Make Up,0,0,0,50,50,0,No,
1,28094,Minuman,600,601,1,5,5,0,0.17%,
1,28095,Minuman,315,360,45,3,3,0,14.29%,
1,28226,Perawatan Hewan,0,48,48,9,0,-9,100.00%,Yes
1,28237,Shampoo & Conditioner,0,0,0,77,77,0,No,
1,28263,Permen,0,0,0,50,50,0,No,
1,28312,,0,0,0,116,116,0,No,
1,28375,Snack,0,0,0,10,10,0,No,
1,28530,Susu & Olahan Susu,600,600,0,35,35,0,No,
1,28576,Biskuit,135,221,86,42,26,-16,63.70%,
1,28577,Biskuit,0,66,66,3,0,-3,100.00%,Yes
1,28579,Kebutuhan Ibu & Bayi,24,24,0,3,3,0,No,
1,28726,Snack,0,0,0,28,28,0,No,
1,28794,Perawatan Rumah,0,24,24,52,0,-52,100.00%,Yes
1,28826,Biskuit,160,160,0,33,33,0,No,
1,28828,Sarapan,0,84,84,88,0,-88,100.00%,Yes
1,28831,Alat Kesehatan,104,88,-16,9,11,2,No,
1,28840,Perawatan Hewan,96,96,0,9,9,0,No,
1,28841,Perawatan Hewan,96,96,0,73,73,0,No,
1,28842,Perawatan Hewan,60,60,0,49,49,0,No,
1,28866,Snack,0,0,0,10,10,0,No,
1,28955,Perawatan Hewan,96,96,0,78,78,0,No,
1,28961,Perawatan Hewan,0,0,0,20,20,0,No,
1,28962,Perawatan Hewan,72,72,0,13,13,0,No,
1,28964,Perawatan Hewan,81,81,0,16,16,0,No,
1,28966,Perawatan Hewan,108,108,0,36,36,0,No,
1,28968,Perawatan Hewan,72,88,16,15,13,-2,22.22%,
1,28970,Perawatan Hewan,68,68,0,28,28,0,No,
1,29180,Perawatan Diri ,240,204,-36,18,22,4,No,
1,29235,,144,144,0,10,10,0,No,
1,29534,Gas & Air Galon,1200,1320,120,45,41,-4,10.00%,
1,29544,Alat Kesehatan,87,149,62,12,8,-4,71.26%,
1,29580,Perawatan Hewan,0,0,0,4,4,0,No,
1,29586,Alat Kesehatan,48,48,0,1,1,0,No,
1,29590,Kebutuhan Cuci Baju,906,804,-102,13,15,2,No,
1,29599,Shampoo & Conditioner,666,594,-72,13,15,2,No,
1,29600,Kebutuhan Ibu & Bayi,288,240,-48,60,72,12,No,
1,29601,Kebutuhan Ibu & Bayi,0,0,0,65,65,0,No,
1,29602,Kebutuhan Ibu & Bayi,36,0,-36,10,10,0,No,
1,29603,Kebersihan Badan,324,300,-24,12,13,1,No,
1,29630,Sarapan,258,258,0,43,43,0,No,
1,29637,Cokelat,0,0,0,24,24,0,No,
1,29647,Perawatan Diri ,0,0,0,88,88,0,No,
1,29661,Kebersihan Badan,0,7,7,28,0,-28,100.00%,Yes
1,29662,Kebersihan Badan,7,15,8,70,33,-37,114.29%,
1,29663,Kebersihan Badan,25,39,14,52,34,-18,56.00%,
1,29715,Kebersihan Wajah,48,48,0,8,8,0,No,
1,29725,,0,144,144,40,0,-40,100.00%,Yes
1,29746,Perawatan Hewan,108,264,156,33,14,-19,144.44%,
1,29813,Perawatan Rumah,0,0,0,60,60,0,No,
1,29886,Biskuit,0,0,0,1,1,0,No,
1,29909,Snack,12,84,72,7,1,-6,600.00%,
1,29920,Sarapan,0,0,0,84,84,0,No,
1,29942,Sarapan,0,0,0,63,63,0,No,
1,30055,Sarapan,144,234,90,82,51,-31,62.50%,
1,30213,Bahan Masak & Bumbu,0,0,0,3,3,0,No,
1,30219,Snack,245,315,70,23,18,-5,28.57%,
1,30410,Snack,0,0,0,41,41,0,No,
1,30443,,312,384,72,115,94,-21,23.08%,
1,30494,Peralatan Dapur,0,0,0,1,1,0,No,
1,30510,Susu & Olahan Susu,0,0,0,7,7,0,No,
1,30527,,700,700,0,10,10,0,No,
1,30542,Bahan Masak & Bumbu,0,144,144,51,0,-51,100.00%,Yes
1,30544,Obat-obatan,0,0,0,3,3,0,No,
1,30547,Vitamin,0,0,0,7,7,0,No,
1,30589,Bahan Masak & Bumbu,24,24,0,17,17,0,No,
1,30599,Sarapan,0,0,0,3,3,0,No,
1,30728,Snack,0,0,0,1,1,0,No,
1,30762,Cokelat,0,0,0,203,203,0,No,
1,30767,Kebersihan Badan,156,180,24,82,72,-10,15.38%,
1,30817,Biskuit,0,0,0,66,66,0,No,
1,30879,Kebersihan Badan,24,24,0,28,28,0,No,
1,30891,Kebutuhan Ibu & Bayi,24,24,0,1,1,0,No,
1,31018,Snack,0,0,0,1,1,0,No,
1,31020,Snack,0,0,0,12,12,0,No,
1,31021,Snack,96,84,-12,1,2,1,No,
1,31024,Kebutuhan Pokok,1220,1220,0,69,69,0,No,
1,31026,,0,0,0,104,104,0,No,
1,31108,Snack,0,24,24,46,0,-46,100.00%,Yes
1,31109,Snack,0,24,24,28,0,-28,100.00%,Yes
1,31210,Perawatan Hewan,144,192,48,5,4,-1,33.33%,
1,31216,Skincare,12,12,0,13,13,0,No,
1,31232,Kebersihan Wajah,48,48,0,1,1,0,No,
1,31273,Susu & Olahan Susu,0,0,0,45,45,0,No,
1,31285,Sarapan,350,350,0,28,28,0,No,
1,31311,Skincare,14,17,3,4,4,0,21.43%,
1,31372,Snack,100,100,0,33,33,0,No,
1,31373,Snack,200,200,0,6,6,0,No,
1,31374,Snack,20,30,10,27,18,-9,50.00%,
1,31384,Obat-obatan,156,156,0,11,11,0,No,
1,31387,Obat-obatan,12,12,0,7,7,0,No,
1,31395,Kebutuhan Cuci Baju,312,432,120,5,4,-1,38.46%,
1,31400,Bahan Masak & Bumbu,0,0,0,3,3,0,No,
1,31423,Kebutuhan Cuci Baju,0,0,0,1,1,0,No,
1,31428,Kebutuhan Cuci Baju,196,172,-24,2,3,1,No,
1,31432,Vitamin,0,0,0,3,3,0,No,
1,31437,Kebutuhan Cuci Baju,84,72,-12,2,3,1,No,
1,31438,Kebutuhan Cuci Baju,114,102,-12,23,26,3,No,
1,31439,,144,144,0,140,140,0,No,
1,31441,Perawatan Diri ,72,72,0,1,1,0,No,
1,31483,Perawatan Hewan,120,144,24,8,7,-1,20.00%,
1,31486,Perawatan Hewan,72,72,0,27,27,0,No,
1,31603,Biskuit,0,0,0,30,30,0,No,
1,31605,Biskuit,24,112,88,10,3,-7,366.67%,
1,31671,Skincare,12,22,10,3,2,-1,83.33%,
1,31706,Susu & Olahan Susu,0,0,0,2,2,0,No,
1,31735,Perawatan Rumah,80,80,0,27,27,0,No,
1,31740,Perawatan Rumah,0,0,0,8,8,0,No,
1,31867,Snack,80,670,590,3,1,-2,737.50%,
1,31868,Snack,0,230,230,4,0,-4,100.00%,Yes
1,31870,Snack,10,340,330,22,1,-21,3300.00%,
1,31871,Snack,0,330,330,14,0,-14,100.00%,Yes
1,31884,Susu & Olahan Susu,24,288,264,19,2,-17,1100.00%,
1,31903,Perawatan Rumah,96,192,96,50,25,-25,100.00%,
1,31910,Perawatan Rumah,0,0,0,7,7,0,No,
1,31951,Fashion Aksesoris,0,0,0,3,3,0,No,
1,31957,Fashion Aksesoris,0,0,0,1,1,0,No,
1,31985,Perawatan Rumah,0,0,0,60,60,0,No,
1,32036,Gas & Air Galon,0,919,919,5,0,-5,100.00%,Yes
1,32054,Produk 21+,309,309,0,4,4,0,No,
1,32066,Bahan Masak & Bumbu,120,240,120,48,24,-24,100.00%,
1,32068,Bahan Masak & Bumbu,240,600,360,65,26,-39,150.00%,
1,32083,Kebutuhan Ibu & Bayi,0,0,0,30,30,0,No,
1,32084,Kebutuhan Ibu & Bayi,24,24,0,6,6,0,No,
1,32085,Vitamin,0,0,0,53,53,0,No,
1,32091,Vitamin,0,60,60,3,0,-3,100.00%,Yes
1,32098,Fashion Aksesoris,328,138,-190,3,8,5,No,
1,32107,Bahan Masak & Bumbu,50,50,0,6,6,0,No,
1,32112,Sarapan,0,0,0,32,32,0,No,
1,32147,Perawatan Rumah,180,300,120,6,4,-2,66.67%,
1,32178,Minuman,0,0,0,24,24,0,No,
1,32194,Minuman,0,0,0,70,70,0,No,
1,32195,Minuman,0,0,0,21,21,0,No,
1,32196,Minuman,0,0,0,28,28,0,No,
1,32229,Snack,32,32,0,2,2,0,No,
1,32239,Bahan Masak & Bumbu,0,0,0,22,22,0,No,
1,32244,Minuman,125,96,-29,30,40,10,No,
1,32398,Bahan Masak & Bumbu,0,24,24,6,0,-6,100.00%,Yes
1,32417,Susu & Olahan Susu,0,0,0,66,66,0,No,
1,32549,,0,0,0,3,3,0,No,
1,32598,Susu & Olahan Susu,0,0,0,12,12,0,No,
1,32606,Obat-obatan,480,396,-84,4,5,1,No,
1,32619,Perawatan Hewan,0,0,0,14,14,0,No,
1,32715,Bahan Masak & Bumbu,36,36,0,23,23,0,No,
1,32735,Snack,0,0,0,56,56,0,No,
1,32738,Bahan Masak & Bumbu,0,0,0,4,4,0,No,
1,32746,Perawatan Diri ,96,96,0,58,58,0,No,
1,32747,Perawatan Diri ,24,24,0,38,38,0,No,
1,32749,Perawatan Rumah,144,144,0,1,1,0,No,
1,32816,Obat-obatan,150,0,-150,1,1,0,No,
1,32834,Perawatan Mulut,48,144,96,6,2,-4,200.00%,
1,32836,Kebersihan Badan,48,48,0,13,13,0,No,
1,32840,Perawatan Diri ,0,0,0,5,5,0,No,
1,32841,Perawatan Diri ,0,0,0,23,23,0,No,
1,32842,Perawatan Diri ,0,0,0,51,51,0,No,
1,32843,Perawatan Diri ,0,0,0,75,75,0,No,
1,32844,Perawatan Diri ,0,0,0,9,9,0,No,
1,32883,Susu & Olahan Susu,0,0,0,8,8,0,No,
1,32984,Sarapan,0,16,16,23,0,-23,100.00%,Yes
1,32986,Sarapan,0,32,32,13,0,-13,100.00%,Yes
1,32993,Bahan Masak & Bumbu,612,612,0,4,4,0,No,
1,32998,Obat-obatan,156,132,-24,52,62,10,No,
1,33082,Vitamin,0,0,0,34,34,0,No,
1,33084,Bahan Masak & Bumbu,0,0,0,4,4,0,No,
1,33085,Vitamin,0,0,0,7,7,0,No,
1,33156,Susu & Olahan Susu,0,0,0,2,2,0,No,
1,33277,Bahan Masak & Bumbu,0,0,0,70,70,0,No,
1,33304,Bahan Masak & Bumbu,60,0,-60,73,73,0,No,
1,33372,Obat-obatan,0,0,0,18,18,0,No,
1,33386,Kebutuhan Ibu & Bayi,15,20,5,4,3,-1,33.33%,
1,33394,Vitamin,120,160,40,8,6,-2,33.33%,
1,33514,Kebutuhan Pokok,0,0,0,4,4,0,No,
1,33657,Perawatan Rumah,588,588,0,3,3,0,No,
1,33685,Biskuit,160,160,0,11,11,0,No,
1,33736,Fashion Aksesoris,600,200,-400,31,93,62,No,
1,33737,Fashion Aksesoris,200,100,-100,1,2,1,No,
1,33738,Fashion Aksesoris,300,200,-100,63,95,32,No,
1,33742,Alat Kesehatan,120,108,-12,23,26,3,No,
1,33746,Obat-obatan,48,0,-48,2,2,0,No,
1,33756,Kebersihan Wajah,48,48,0,5,5,0,No,
1,33787,Cokelat,0,0,0,203,203,0,No,
1,33855,Alat Tulis Kantor,58,0,-58,2,2,0,No,
1,33856,Alat Tulis Kantor,0,0,0,33,33,0,No,
1,33878,Produk 21+,40,45,5,1,1,0,12.50%,
1,33883,Produk 21+,0,10,10,74,0,-74,100.00%,Yes
1,33884,Produk 21+,0,3,3,34,0,-34,100.00%,Yes
1,33937,Susu & Olahan Susu,66,138,72,147,71,-76,109.09%,
1,33957,Obat-obatan,0,0,0,57,57,0,No,
1,33958,Obat-obatan,0,0,0,3,3,0,No,
1,33959,Obat-obatan,0,0,0,1,1,0,No,
1,33960,Obat-obatan,2,8,6,2,1,-1,300.00%,
1,33975,Produk 21+,480,480,0,119,119,0,No,
1,34014,Obat-obatan,21,21,0,2,2,0,No,
1,34031,Minuman,0,12,12,16,0,-16,100.00%,Yes
1,34062,Skincare,0,30,30,6,0,-6,100.00%,Yes
1,34065,Skincare,0,0,0,2,2,0,No,
1,34066,Skincare,0,0,0,40,40,0,No,
1,34070,,48,48,0,26,26,0,No,
1,34128,Tata Rumah,48,48,0,2,2,0,No,
1,34161,Vitamin,0,0,0,1,1,0,No,
1,34162,Vitamin,30,30,0,10,10,0,No,
1,34205,Obat-obatan,0,0,0,4,4,0,No,
1,34268,Permen,576,0,-576,119,119,0,No,
1,34269,Permen,576,288,-288,58,116,58,No,
1,34270,Permen,288,0,-288,74,74,0,No,
1,34276,Kebersihan Wajah,120,120,0,26,26,0,No,
1,34277,Kebersihan Wajah,120,120,0,17,17,0,No,
1,34339,Cokelat,0,0,0,134,134,0,No,
1,34352,Makanan & Susu Bayi,0,0,0,12,12,0,No,
1,34353,Makanan & Susu Bayi,0,0,0,17,17,0,No,
1,34414,Susu & Olahan Susu,0,0,0,53,53,0,No,
1,34418,Biskuit,0,0,0,37,37,0,No,
1,34423,Kebutuhan Ibu & Bayi,0,0,0,80,80,0,No,
1,34455,Alat Tulis Kantor,0,0,0,11,11,0,No,
1,34468,Alat Tulis Kantor,0,0,0,9,9,0,No,
1,34478,Alat Tulis Kantor,0,0,0,19,19,0,No,
1,34479,Alat Tulis Kantor,0,0,0,3,3,0,No,
1,34489,Snack,144,360,216,98,40,-58,150.00%,
1,34528,Sarapan,0,0,0,84,84,0,No,
1,34529,Perawatan Rumah,0,0,0,53,53,0,No,
1,34531,Perawatan Rumah,0,0,0,13,13,0,No,
1,34532,Perawatan Rumah,0,120,120,101,0,-101,100.00%,Yes
1,34533,Perawatan Rumah,0,0,0,11,11,0,No,
1,34561,Perawatan Hewan,35,50,15,18,13,-5,42.86%,
1,34562,,60,106,46,55,32,-23,76.67%,
1,34575,Perawatan Rumah,420,240,-180,1,2,1,No,
1,34596,Make Up,0,24,24,27,0,-27,100.00%,Yes
1,34597,Make Up,0,0,0,32,32,0,No,
1,34598,Make Up,0,0,0,14,14,0,No,
1,34701,Produk 21+,40,40,0,5,5,0,No,
1,34708,,12,36,24,28,10,-18,200.00%,
1,34712,Snack,0,0,0,22,22,0,No,
1,34722,Kebutuhan Ibu & Bayi,48,48,0,3,3,0,No,
1,34730,Permen,144,144,0,13,13,0,No,
1,34739,Make Up,24,24,0,9,9,0,No,
1,34752,Shampoo & Conditioner,0,0,0,2,2,0,No,
1,34776,Make Up,0,0,0,35,35,0,No,
1,34779,Biskuit,48,72,24,39,26,-13,50.00%,
1,34838,Biskuit,24,72,48,115,39,-76,200.00%,
1,34876,Kebersihan Wajah,0,0,0,5,5,0,No,
1,34889,Perawatan Diri ,108,108,0,31,31,0,No,
1,34890,Perawatan Diri ,120,132,12,16,15,-1,10.00%,
1,34928,,24,24,0,6,6,0,No,
1,34935,HP & Gadget,0,0,0,1,1,0,No,
1,34948,Vitamin,0,0,0,97,97,0,No,
1,34949,Vitamin,41,41,0,14,14,0,No,
1,34950,,0,0,0,196,196,0,No,
1,34951,,0,0,0,196,196,0,No,
1,34989,Skincare,264,264,0,189,189,0,No,
1,34990,Skincare,432,432,0,203,203,0,No,
1,35040,Shampoo & Conditioner,60,60,0,36,36,0,No,
1,35044,Kebersihan Badan,72,72,0,13,13,0,No,
1,35045,Shampoo & Conditioner,50,50,0,5,5,0,No,
1,35063,Sarapan,48,144,96,16,6,-10,200.00%,
1,35139,Make Up,0,0,0,1,1,0,No,
1,35164,Kebutuhan Ibu & Bayi,48,0,-48,2,2,0,No,
1,35187,Biskuit,240,240,0,59,59,0,No,
1,35188,Biskuit,0,0,0,42,42,0,No,
1,35260,Vitamin,0,0,0,6,6,0,No,
1,35265,Perawatan Diri ,24,24,0,22,22,0,No,
1,35267,Perawatan Diri ,0,0,0,6,6,0,No,
1,35289,Snack,0,0,0,78,78,0,No,
1,35291,Snack,0,0,0,17,17,0,No,
1,35332,Snack,0,0,0,7,7,0,No,
1,35342,Obat-obatan,0,0,0,47,47,0,No,
1,35344,Obat-obatan,0,0,0,3,3,0,No,
1,35363,Susu & Olahan Susu,0,0,0,8,8,0,No,
1,35372,Kids Selection,0,36,36,23,0,-23,100.00%,Yes
1,35384,Minuman,0,0,0,25,25,0,No,
1,35391,Kebutuhan Pokok,1296,1296,0,2,2,0,No,
1,35426,Makanan & Susu Bayi,0,0,0,1,1,0,No,
1,35428,Makanan & Susu Bayi,0,0,0,26,26,0,No,
1,35429,Makanan & Susu Bayi,0,0,0,27,27,0,No,
1,35430,Makanan & Susu Bayi,0,0,0,12,12,0,No,
1,35431,Makanan & Susu Bayi,0,0,0,2,2,0,No,
1,35432,Makanan & Susu Bayi,0,0,0,17,17,0,No,
1,35435,Makanan & Susu Bayi,0,0,0,4,4,0,No,
1,35459,Susu & Olahan Susu,72,48,-24,4,6,2,No,
1,35461,Susu & Olahan Susu,72,48,-24,13,20,7,No,
1,35549,Shampoo & Conditioner,0,0,0,1,1,0,No,
1,35550,Shampoo & Conditioner,24,24,0,20,20,0,No,
1,35552,Tepung & Bahan Kue,0,24,24,103,0,-103,100.00%,Yes
1,35766,Sarapan,36,36,0,21,21,0,No,
1,35771,,120,80,-40,14,21,7,No,
1,35772,Permen,216,144,-72,1,2,1,No,
1,35796,Obat-obatan,36,36,0,7,7,0,No,
1,35800,Perawatan Rumah,78,66,-12,17,21,4,No,
1,35801,,378,408,30,85,79,-6,7.94%,
1,35802,Kebutuhan Cuci Baju,30,12,-18,5,13,8,No,
1,35803,Kebutuhan Cuci Baju,192,174,-18,33,37,4,No,
1,35806,Kebutuhan Dapur,240,204,-36,8,10,2,No,
1,35807,Shampoo & Conditioner,15,9,-6,4,7,3,No,
1,35808,Perawatan Mulut,42,29,-13,17,25,8,No,
1,35824,Make Up,0,0,0,99,99,0,No,
1,35825,Make Up,3,3,0,169,169,0,No,
1,35826,Make Up,0,0,0,129,129,0,No,
1,35827,Make Up,0,0,0,28,28,0,No,
1,35828,Make Up,0,0,0,78,78,0,No,
1,35846,Kebutuhan Pokok,420,960,540,4,2,-2,128.57%,
1,35847,Kebutuhan Pokok,120,80,-40,25,38,13,No,
1,35849,Susu & Olahan Susu,48,96,48,5,3,-2,100.00%,
1,35918,Perawatan Diri ,224,58,-166,17,66,49,No,
1,36207,,0,48,48,51,0,-51,100.00%,Yes
1,36208,Minuman,0,12,12,4,0,-4,100.00%,Yes
1,36209,Minuman,0,12,12,58,0,-58,100.00%,Yes
1,36210,,0,0,0,52,52,0,No,
1,36224,Obat-obatan,0,0,0,47,47,0,No,
1,36227,Obat-obatan,0,0,0,7,7,0,No,
1,36231,Perawatan Rumah,0,0,0,120,120,0,No,
1,36255,Peralatan Dapur,24,24,0,1,1,0,No,
1,36268,Minuman,0,0,0,2,2,0,No,
1,36280,Vitamin,0,0,0,4,4,0,No,
1,36401,Skincare,0,0,0,7,7,0,No,
1,36402,Skincare,24,32,8,2,2,0,33.33%,
1,36416,Susu & Olahan Susu,0,0,0,1,1,0,No,
1,36451,Tepung & Bahan Kue,0,0,0,169,169,0,No,
1,36452,Makanan & Susu Bayi,0,0,0,3,3,0,No,
1,36454,Makanan & Susu Bayi,60,120,60,46,23,-23,100.00%,
1,36456,Makanan & Susu Bayi,264,408,144,2,2,0,54.55%,
1,36457,Makanan & Susu Bayi,288,396,108,11,8,-3,37.50%,
1,36459,Makanan & Susu Bayi,36,96,60,3,2,-1,166.67%,
1,36473,Snack,36,24,-12,5,8,3,No,
1,36474,Snack,0,0,0,2,2,0,No,
1,36475,Snack,24,0,-24,1,1,0,No,
1,36497,Makanan & Susu Bayi,0,0,0,1,1,0,No,
1,36504,Snack,216,216,0,3,3,0,No,
1,36505,Snack,0,0,0,1,1,0,No,
1,36506,Snack,36,36,0,4,4,0,No,
1,36510,Perawatan Hewan,24,48,24,3,2,-1,100.00%,
1,36511,Obat-obatan,49,49,0,35,35,0,No,
1,36512,Obat-obatan,9,9,0,78,78,0,No,
1,36513,Perawatan Hewan,24,24,0,7,7,0,No,
1,36514,Perawatan Hewan,24,24,0,7,7,0,No,
1,36516,Perawatan Hewan,0,48,48,7,0,-7,100.00%,Yes
1,36591,Minuman,0,55,55,119,0,-119,100.00%,Yes
1,36602,,0,0,0,29,29,0,No,
1,36603,,0,0,0,11,11,0,No,
1,36605,Alat Kesehatan,121,143,22,50,43,-7,18.18%,
1,36644,Kids Selection,0,20,20,28,0,-28,100.00%,Yes
1,36645,Kids Selection,0,63,63,78,0,-78,100.00%,Yes
1,36646,Kids Selection,0,27,27,7,0,-7,100.00%,Yes
1,36648,Tata Rumah,18,52,34,68,24,-44,188.89%,
1,36651,Alat Kesehatan,70,92,22,16,13,-3,31.43%,
1,36652,Alat Kesehatan,32,39,7,24,20,-4,21.88%,
1,36662,Snack,0,0,0,64,64,0,No,
1,36663,Snack,0,0,0,53,53,0,No,
1,36664,Snack,0,48,48,118,0,-118,100.00%,Yes
1,36671,Bahan Masak & Bumbu,60,60,0,40,40,0,No,
1,36673,Bahan Masak & Bumbu,0,0,0,1,1,0,No,
1,36674,Bahan Masak & Bumbu,24,24,0,47,47,0,No,
1,36675,Minuman,40,60,20,8,6,-2,50.00%,
1,36677,Tepung & Bahan Kue,80,80,0,5,5,0,No,
1,36678,Bahan Masak & Bumbu,351,363,12,6,6,0,3.42%,
1,36680,Kebutuhan Pokok,0,0,0,4,4,0,No,
1,36707,Perawatan Hewan,64,64,0,15,15,0,No,
1,36710,Vitamin,0,0,0,14,14,0,No,
1,36716,Perawatan Hewan,0,0,0,52,52,0,No,
1,36717,Perawatan Hewan,0,0,0,57,57,0,No,
1,36719,Perawatan Hewan,0,64,64,37,0,-37,100.00%,Yes
1,36720,Perawatan Hewan,64,64,0,18,18,0,No,
1,36721,Perawatan Hewan,64,64,0,34,34,0,No,
1,36748,Perawatan Diri ,0,0,0,4,4,0,No,
1,36770,Tepung & Bahan Kue,0,0,0,7,7,0,No,
1,36784,Snack,84,156,72,75,41,-34,85.71%,
1,36785,,24,84,60,40,12,-28,250.00%,
1,36796,Vitamin,37,37,0,6,6,0,No,
1,36797,Vitamin,40,40,0,38,38,0,No,
1,36798,Vitamin,18,18,0,38,38,0,No,
1,36799,Vitamin,0,0,0,19,19,0,No,
1,36802,Vitamin,120,50,-70,59,142,83,No,
1,36803,Peralatan Ibu & Bayi,24,57,33,17,8,-9,137.50%,
1,36808,Shampoo & Conditioner,24,24,0,2,2,0,No,
1,36809,Shampoo & Conditioner,72,24,-48,1,3,2,No,
1,36845,Sarapan,0,120,120,9,0,-9,100.00%,Yes
1,36876,Minuman,48,48,0,24,24,0,No,
1,36877,Minuman,0,0,0,30,30,0,No,
1,36878,Minuman,0,0,0,9,9,0,No,
1,36879,Minuman,0,0,0,15,15,0,No,
1,36880,Minuman,0,0,0,1,1,0,No,
1,36916,Makanan & Susu Bayi,0,0,0,11,11,0,No,
1,36917,Bahan Masak & Bumbu,48,48,0,26,26,0,No,
1,36918,Bahan Masak & Bumbu,0,0,0,26,26,0,No,
1,36920,Makanan & Susu Bayi,0,0,0,4,4,0,No,
1,36922,Makanan & Susu Bayi,48,48,0,1,1,0,No,
1,36924,Bahan Masak & Bumbu,0,0,0,9,9,0,No,
1,36926,Bahan Masak & Bumbu,0,0,0,40,40,0,No,
1,36927,Bahan Masak & Bumbu,48,48,0,9,9,0,No,
1,36928,Bahan Masak & Bumbu,0,0,0,71,71,0,No,
1,36929,Bahan Masak & Bumbu,0,0,0,12,12,0,No,
1,36930,Minuman,240,240,0,20,20,0,No,
1,36939,Kebutuhan Pokok,48,48,0,22,22,0,No,
1,36946,Alat Kesehatan,400,600,200,60,40,-20,50.00%,
1,36972,Snack,0,0,0,157,157,0,No,
1,36973,Snack,0,0,0,26,26,0,No,
1,36976,Gas & Air Galon,187,230,43,34,28,-6,22.99%,
1,36979,Peralatan Dapur,78,86,8,188,171,-17,10.26%,
1,36981,Alat Tulis Kantor,115,115,0,76,76,0,No,
1,36989,Make Up,0,0,0,1,1,0,No,
1,36991,Make Up,84,84,0,25,25,0,No,
1,36997,Make Up,19,19,0,14,14,0,No,
1,37011,Tepung & Bahan Kue,90,36,-54,10,25,15,No,
1,37018,Tata Rumah,48,48,0,92,92,0,No,
1,37019,Perawatan Hewan,0,0,0,175,175,0,No,
1,37021,Make Up,72,72,0,133,133,0,No,
1,37033,Kebutuhan Ibu & Bayi,24,36,12,9,6,-3,50.00%,
1,37035,HP & Gadget,0,0,0,44,44,0,No,
1,37048,Snack,90,0,-90,70,70,0,No,
1,37121,Kebersihan Badan,70,84,14,71,60,-11,20.00%,
1,37122,Kebersihan Badan,34,46,12,158,117,-41,35.29%,
1,37123,Kebersihan Badan,40,49,9,85,70,-15,22.50%,
1,37159,Minuman,24,24,0,16,16,0,No,
1,37187,Make Up,0,0,0,39,39,0,No,
1,37199,Make Up,40,40,0,18,18,0,No,
1,37383,Snack,0,0,0,51,51,0,No,
1,37384,Snack,0,0,0,39,39,0,No,
1,37385,Snack,0,0,0,99,99,0,No,
1,37486,Kebutuhan Pokok,0,0,0,14,14,0,No,
1,37487,Kebutuhan Pokok,0,0,0,56,56,0,No,
1,37489,Kebutuhan Pokok,36,36,0,3,3,0,No,
1,37544,Alat Kesehatan,24,24,0,154,154,0,No,
1,37551,Perawatan Hewan,24,24,0,5,5,0,No,
1,37574,Fashion Aksesoris,48,48,0,107,107,0,No,
1,37580,Fashion Aksesoris,84,84,0,131,131,0,No,
1,37658,Snack,0,0,0,168,168,0,No,
1,37659,Snack,90,90,0,57,57,0,No,
1,37660,Snack,0,0,0,104,104,0,No,
1,37661,Snack,0,0,0,131,131,0,No,
1,37662,Snack,0,0,0,56,56,0,No,
1,37663,Snack,0,0,0,65,65,0,No,
1,37665,Cokelat,12,12,0,63,63,0,No,
1,37666,Snack,0,0,0,1,1,0,No,
1,37668,Snack,0,0,0,11,11,0,No,
1,37670,Snack,0,0,0,141,141,0,No,
1,37672,Snack,24,24,0,18,18,0,No,
1,37681,,0,0,0,48,48,0,No,
1,37684,Kebutuhan Cuci Baju,38,38,0,43,43,0,No,
1,37685,Kebutuhan Cuci Baju,112,112,0,140,140,0,No,
1,37687,Perawatan Rumah,96,96,0,129,129,0,No,
1,37688,Peralatan Ibu & Bayi,39,39,0,7,7,0,No,
1,37689,Peralatan Ibu & Bayi,41,41,0,10,10,0,No,
1,37690,Peralatan Ibu & Bayi,64,64,0,24,24,0,No,
1,37813,Perawatan Hewan,0,0,0,73,73,0,No,
1,38444,Perawatan Diri ,120,120,0,83,83,0,No,
1,38446,Perawatan Diri ,72,72,0,10,10,0,No,
1,38449,Susu & Olahan Susu,108,36,-72,2,6,4,No,
1,38450,Susu & Olahan Susu,108,36,-72,6,18,12,No,
1,38735,Susu & Olahan Susu,72,72,0,54,54,0,No,
1,38799,Snack,24,24,0,18,18,0,No,
1,38800,Snack,24,24,0,3,3,0,No,
1,39035,Perawatan Diri ,38,38,0,7,7,0,No,
1,39036,Perawatan Hewan,0,0,0,10,10,0,No,
1,39037,Perawatan Hewan,0,0,0,3,3,0,No,
1,39038,Perawatan Hewan,0,0,0,6,6,0,No,
1,39039,Perawatan Hewan,6,6,0,12,12,0,No,
1,39514,Make Up,30,36,6,1,1,0,20.00%,
1,39515,Make Up,30,36,6,3,3,0,20.00%,
1,40314,Kebutuhan Pokok,60,60,0,34,34,0,No,
1,40315,Perawatan Mulut,6,30,24,2,1,-1,400.00%,
1,40317,Perawatan Mulut,33,33,0,7,7,0,No,
1,40323,Skincare,24,24,0,2,2,0,No,
1,40333,Kebutuhan Ibu & Bayi,32,32,0,2,2,0,No,
1,40350,Snack,108,108,0,52,52,0,No,
1,40351,Snack,120,120,0,57,57,0,No,
1,40352,Snack,120,120,0,60,60,0,No,
1,40374,Obat-obatan,44,44,0,2,2,0,No,
1,40387,Make Up,32,32,0,21,21,0,No,
1,40388,Make Up,0,0,0,15,15,0,No,
1,40389,Make Up,0,0,0,7,7,0,No,
1,40390,Make Up,0,0,0,10,10,0,No,
1,40391,Make Up,0,0,0,9,9,0,No,
1,40392,Make Up,0,0,0,59,59,0,No,
1,40393,Make Up,0,0,0,10,10,0,No,
1,40394,Make Up,0,0,0,15,15,0,No,
1,40395,Make Up,0,0,0,28,28,0,No,
1,40396,Make Up,0,0,0,26,26,0,No,
1,40397,Make Up,0,0,0,8,8,0,No,
1,40398,Make Up,0,0,0,17,17,0,No,
1,40399,Make Up,0,0,0,20,20,0,No,
1,40400,Make Up,0,0,0,6,6,0,No,
1,40401,Make Up,0,0,0,24,24,0,No,
1,40403,Make Up,0,0,0,27,27,0,No,
1,40404,Make Up,0,0,0,23,23,0,No,
1,40405,Make Up,0,0,0,16,16,0,No,
1,40406,Make Up,0,0,0,7,7,0,No,
1,40407,Make Up,0,0,0,21,21,0,No,
1,40408,Make Up,0,0,0,7,7,0,No,
1,40412,Vitamin,48,30,-18,3,5,2,No,
1,40414,Vitamin,48,30,-18,3,5,2,No,
1,40419,Obat-obatan,120,30,-90,3,12,9,No,
1,40422,Obat-obatan,120,30,-90,1,4,3,No,
1,40428,Obat-obatan,60,60,0,6,6,0,No,
1,40456,Shampoo & Conditioner,30,30,0,7,7,0,No,
1,40459,Kebersihan Wajah,30,30,0,7,7,0,No,
1,40462,Perawatan Diri ,84,84,0,1,1,0,No,
1,40630,Sarapan,70,70,0,6,6,0,No,
1,40667,Bahan Masak & Bumbu,70,70,0,4,4,0,No,
1,40701,Snack,96,96,0,2,2,0,No,
1,40726,Minuman,60,60,0,7,7,0,No,
1,40732,Vitamin,60,60,0,2,2,0,No,
1,40774,Kebutuhan Pokok,120,120,0,23,23,0,No,
1,40778,Obat-obatan,100,100,0,2,2,0,No,
1,40832,Make Up,0,0,0,2,2,0,No,
1,40845,Peralatan Dapur,0,0,0,2,2,0,No,
1,40861,Bahan Masak & Bumbu,0,0,0,7,7,0,No,
1,40878,Bahan Masak & Bumbu,0,0,0,2,2,0,No,
1,40884,,0,0,0,10,10,0,No,
1,40886,,0,0,0,11,11,0,No,
1,40887,Snack,0,0,0,12,12,0,No,
1,40924,Peralatan Dapur,0,0,0,7,7,0,No,
2,13,Perawatan Mulut,192,288,96,32,22,-10,50.00%,
2,34,,0,0,0,44,44,0,No,
2,64,Tata Rumah,0,0,0,1,1,0,No,
2,70,,22,22,0,16,16,0,No,
2,116,Alat Kesehatan,112,224,112,97,49,-48,100.00%,
2,153,Makanan & Susu Bayi,0,0,0,28,28,0,No,
2,178,Kebutuhan Cuci Baju,132,168,36,27,22,-5,27.27%,
2,181,Alat Kesehatan,30,30,0,6,6,0,No,
2,191,Makanan & Susu Bayi,72,120,48,17,11,-6,66.67%,
2,199,Bahan Masak & Bumbu,0,0,0,1,1,0,No,
2,209,Obat-obatan,120,144,24,95,80,-15,20.00%,
2,225,Perawatan Diri ,540,936,396,1,1,0,73.33%,
2,234,Sarapan,48,60,12,35,28,-7,25.00%,
2,258,Perawatan Mulut,96,168,72,54,31,-23,75.00%,
2,259,Vitamin,60,110,50,22,12,-10,83.33%,
2,281,Obat-obatan,96,96,0,1,1,0,No,
2,352,Snack,250,350,100,23,17,-6,40.00%,
2,365,Biskuit,272,384,112,45,32,-13,41.18%,
2,418,Alat Kesehatan,0,0,0,138,138,0,No,
2,427,Kebersihan Badan,0,0,0,73,73,0,No,
2,435,Alat Tulis Kantor,0,0,0,4,4,0,No,
2,454,Minuman,0,0,0,24,24,0,No,
2,458,Sarapan,72,72,0,30,30,0,No,
2,492,Vitamin,0,0,0,5,5,0,No,
2,507,Minuman,0,0,0,1,1,0,No,
2,525,Perawatan Rumah,220,220,0,1,1,0,No,
2,551,Kebutuhan Ibu & Bayi,0,0,0,20,20,0,No,
2,561,,170,290,120,8,5,-3,70.59%,
2,567,Alat Kesehatan,24,24,0,14,14,0,No,
2,569,Bahan Masak & Bumbu,1560,2208,648,30,22,-8,41.54%,
2,570,Susu & Olahan Susu,1872,2352,480,1,1,0,25.64%,
2,584,Kebutuhan Ibu & Bayi,0,0,0,8,8,0,No,
2,606,Obat-obatan,0,0,0,1,1,0,No,
2,610,Perawatan Rumah,180,180,0,3,3,0,No,
2,618,Minuman,168,216,48,21,17,-4,28.57%,
2,625,Biskuit,432,576,144,97,73,-24,33.33%,
2,633,Alat Tulis Kantor,0,0,0,1,1,0,No,
2,635,Kebersihan Wajah,48,72,24,35,24,-11,50.00%,
2,658,Sarapan,432,576,144,85,64,-21,33.33%,
2,695,Kebersihan Wajah,0,0,0,17,17,0,No,
2,712,Bahan Masak & Bumbu,696,1068,372,4,3,-1,53.45%,
2,713,Alat Tulis Kantor,336,504,168,1,1,0,50.00%,
2,719,Vitamin,312,312,0,55,55,0,No,
2,724,Perawatan Hewan,105,150,45,30,21,-9,42.86%,
2,733,Tepung & Bahan Kue,0,0,0,26,26,0,No,
2,757,Kebutuhan Pokok,20,20,0,12,12,0,No,
2,765,Alat Tulis Kantor,0,0,0,10,10,0,No,
2,771,Snack,144,150,6,132,127,-5,4.17%,
2,786,Makanan & Susu Bayi,0,0,0,18,18,0,No,
2,830,Bahan Masak & Bumbu,1248,1704,456,27,20,-7,36.54%,
2,844,Obat-obatan,96,156,60,5,4,-1,62.50%,
2,846,Permen,288,288,0,32,32,0,No,
2,847,Obat-obatan,360,360,0,14,14,0,No,
2,853,Snack,0,0,0,10,10,0,No,
2,857,Tepung & Bahan Kue,192,264,72,42,31,-11,37.50%,
2,859,Kebutuhan Pokok,168,264,96,37,24,-13,57.14%,
2,862,Sarapan,48,72,24,24,16,-8,50.00%,
2,865,Bahan Masak & Bumbu,108,132,24,9,8,-1,22.22%,
2,879,Kebutuhan Pokok,288,288,0,1,1,0,No,
2,886,Snack,0,0,0,8,8,0,No,
2,898,Bahan Masak & Bumbu,528,528,0,17,17,0,No,
2,906,Perawatan Mulut,20,20,0,7,7,0,No,
2,916,Sarapan,0,0,0,12,12,0,No,
2,917,Kebutuhan Ibu & Bayi,0,0,0,68,68,0,No,
2,919,Biskuit,48,120,72,2,1,-1,150.00%,
2,921,Sarapan,60,72,12,6,5,-1,20.00%,
2,930,Perawatan Mulut,0,96,96,6,0,-6,100.00%,Yes
2,940,Perawatan Mulut,96,96,0,8,8,0,No,
2,943,Alat Tulis Kantor,0,0,0,41,41,0,No,
2,953,Alat Kesehatan,216,288,72,3,3,0,33.33%,
2,956,Sarapan,240,288,48,159,133,-26,20.00%,
2,957,Biskuit,120,264,144,95,44,-51,120.00%,
2,967,Bahan Masak & Bumbu,72,84,12,3,3,0,16.67%,
2,970,Perawatan Mulut,288,288,0,7,7,0,No,
2,974,Sarapan,228,228,0,1,1,0,No,
2,994,Alat Kesehatan,300,350,50,42,36,-6,16.67%,
2,996,Sarapan,252,300,48,173,146,-27,19.05%,
2,997,Biskuit,336,336,0,23,23,0,No,
2,1000,Biskuit,0,0,0,1,1,0,No,
2,1002,Kebersihan Wajah,456,624,168,208,152,-56,36.84%,
2,1003,Sarapan,360,408,48,29,26,-3,13.33%,
2,1008,Makanan & Susu Bayi,12,24,12,8,4,-4,100.00%,
2,1010,Makanan & Susu Bayi,0,36,36,76,0,-76,100.00%,Yes
2,1017,Bahan Masak & Bumbu,360,420,60,34,30,-4,16.67%,
2,1019,Snack,792,846,54,89,84,-5,6.82%,
2,1026,Perawatan Mulut,48,48,0,20,20,0,No,
2,1027,,504,504,0,25,25,0,No,
2,1036,Sarapan,0,0,0,24,24,0,No,
2,1037,Biskuit,480,480,0,1,1,0,No,
2,1041,Kebutuhan Ibu & Bayi,20,20,0,12,12,0,No,
2,1042,Kebutuhan Ibu & Bayi,44,72,28,12,8,-4,63.64%,
2,1046,Kebutuhan Ibu & Bayi,32,68,36,2,1,-1,112.50%,
2,1047,Kebutuhan Ibu & Bayi,0,0,0,15,15,0,No,
2,1048,Kebutuhan Ibu & Bayi,0,28,28,65,0,-65,100.00%,Yes
2,1049,Sarapan,0,0,0,196,196,0,No,
2,1051,Sarapan,162,162,0,1,1,0,No,
2,1055,Sarapan,126,180,54,113,80,-33,42.86%,
2,1059,Perawatan Hewan,96,144,48,12,8,-4,50.00%,
2,1062,Perawatan Hewan,792,1272,480,6,4,-2,60.61%,
2,1063,Perawatan Hewan,504,672,168,29,22,-7,33.33%,
2,1064,Perawatan Hewan,36,66,30,10,6,-4,83.33%,
2,1065,,240,360,120,13,9,-4,50.00%,
2,1066,Snack,120,120,0,6,6,0,No,
2,1079,Perawatan Rumah,240,240,0,3,3,0,No,
2,1080,Perawatan Rumah,288,288,0,5,5,0,No,
2,1081,Perawatan Rumah,180,180,0,18,18,0,No,
2,1088,Kebutuhan Dapur,144,144,0,2,2,0,No,
2,1090,Kebutuhan Dapur,96,120,24,53,43,-10,25.00%,
2,1092,Kebutuhan Dapur,96,96,0,27,27,0,No,
2,1093,Kebutuhan Dapur,48,48,0,1,1,0,No,
2,1095,Kebutuhan Dapur,240,240,0,10,10,0,No,
2,1096,Kebutuhan Dapur,192,192,0,1,1,0,No,
2,1098,Kebutuhan Dapur,144,144,0,44,44,0,No,
2,1102,Kebutuhan Pokok,0,0,0,8,8,0,No,
2,1103,Kebutuhan Pokok,0,0,0,17,17,0,No,
2,1107,Biskuit,420,540,120,27,21,-6,28.57%,
2,1109,Biskuit,450,570,120,74,59,-15,26.67%,
2,1110,Biskuit,300,300,0,1,1,0,No,
2,1112,Biskuit,570,570,0,9,9,0,No,
2,1115,Biskuit,200,200,0,1,1,0,No,
2,1116,Makanan & Susu Bayi,144,144,0,30,30,0,No,
2,1117,Makanan & Susu Bayi,96,96,0,79,79,0,No,
2,1122,Vitamin,100,100,0,11,11,0,No,
2,1128,Biskuit,432,600,168,9,7,-2,38.89%,
2,1129,Sarapan,1440,1860,420,86,67,-19,29.17%,
2,1132,Biskuit,48,48,0,25,25,0,No,
2,1134,Minuman,1200,1488,288,2,2,0,24.00%,
2,1135,Minuman,264,384,120,27,19,-8,45.45%,
2,1143,Bahan Masak & Bumbu,576,816,240,23,17,-6,41.67%,
2,1147,Alat Tulis Kantor,60,60,0,28,28,0,No,
2,1151,Kebutuhan Pokok,216,288,72,3,3,0,33.33%,
2,1152,Kebutuhan Pokok,504,552,48,4,4,0,9.52%,
2,1157,Otomotif,84,96,12,14,13,-1,14.29%,
2,1160,Perawatan Rumah,120,120,0,1,1,0,No,
2,1164,Perawatan Diri ,84,72,-12,2,3,1,No,
2,1175,Perawatan Mulut,96,96,0,50,50,0,No,
2,1182,Snack,0,0,0,4,4,0,No,
2,1183,Bahan Masak & Bumbu,0,0,0,203,203,0,No,
2,1190,Perawatan Mulut,120,120,0,1,1,0,No,
2,1211,Alat Kesehatan,480,480,0,5,5,0,No,
2,1225,Kebutuhan Cuci Baju,240,312,72,15,12,-3,30.00%,
2,1226,Kebutuhan Cuci Baju,432,552,120,39,31,-8,27.78%,
2,1229,Alat Kesehatan,636,840,204,123,94,-29,32.08%,
2,1240,Snack,990,1296,306,187,143,-44,30.91%,
2,1242,Snack,804,1128,324,92,66,-26,40.30%,
2,1243,Snack,432,624,192,200,139,-61,44.44%,
2,1258,Alat Kesehatan,280,280,0,6,6,0,No,
2,1277,Perawatan Diri ,0,0,0,5,5,0,No,
2,1278,Bahan Masak & Bumbu,288,504,216,26,15,-11,75.00%,
2,1280,Tepung & Bahan Kue,36,60,24,33,20,-13,66.67%,
2,1281,Tepung & Bahan Kue,252,540,288,66,31,-35,114.29%,
2,1282,Tepung & Bahan Kue,96,252,156,63,24,-39,162.50%,
2,1284,Tepung & Bahan Kue,156,264,108,43,26,-17,69.23%,
2,1289,Obat-obatan,24,24,0,6,6,0,No,
2,1296,Biskuit,936,1704,768,184,102,-82,82.05%,
2,1297,Perawatan Rumah,306,570,264,56,31,-25,86.27%,
2,1301,Tepung & Bahan Kue,660,660,0,1,1,0,No,
2,1318,Obat-obatan,336,336,0,4,4,0,No,
2,1326,Kebutuhan Ibu & Bayi,12,12,0,9,9,0,No,
2,1336,Vitamin,192,192,0,11,11,0,No,
2,1337,Obat-obatan,160,200,40,1,1,0,25.00%,
2,1344,Susu & Olahan Susu,0,0,0,1,1,0,No,
2,1348,Susu & Olahan Susu,840,1440,600,84,49,-35,71.43%,
2,1350,Vitamin,0,0,0,182,182,0,No,
2,1362,Kebersihan Badan,135,189,54,16,12,-4,40.00%,
2,1363,Kebersihan Badan,48,72,24,18,12,-6,50.00%,
2,1366,Perawatan Rumah,564,708,144,5,4,-1,25.53%,
2,1368,Alat Kesehatan,24,120,96,7,2,-5,400.00%,
2,1381,Biskuit,30,60,30,11,6,-5,100.00%,
2,1382,Kebutuhan Pokok,180,520,340,44,16,-28,188.89%,
2,1385,Obat-obatan,204,252,48,50,41,-9,23.53%,
2,1388,Alat Kesehatan,310,370,60,10,9,-1,19.35%,
2,1390,Vitamin,150,200,50,1,1,0,33.33%,
2,1394,Obat-obatan,96,108,12,2,2,0,12.50%,
2,1395,Minuman,1044,1044,0,1,1,0,No,
2,1399,Shampoo & Conditioner,24,36,12,6,4,-2,50.00%,
2,1402,Snack,360,360,0,1,1,0,No,
2,1407,Snack,0,0,0,19,19,0,No,
2,1408,Bahan Masak & Bumbu,120,204,84,20,12,-8,70.00%,
2,1409,Kebutuhan Pokok,6432,6432,0,134,134,0,No,
2,1410,Kebutuhan Pokok,5280,6672,1392,146,116,-30,26.36%,
2,1416,Obat-obatan,0,0,0,1,1,0,No,
2,1428,Biskuit,600,810,210,15,12,-3,35.00%,
2,1430,Biskuit,72,144,72,12,6,-6,100.00%,
2,1434,Minuman,2808,3960,1152,1,1,0,41.03%,
2,1436,Sarapan,272,272,0,1,1,0,No,
2,1437,Obat-obatan,0,72,72,1,0,-1,100.00%,Yes
2,1440,Permen,180,180,0,1,1,0,No,
2,1444,Obat-obatan,240,280,40,1,1,0,16.67%,
2,1450,Bahan Masak & Bumbu,264,552,288,16,8,-8,109.09%,
2,1460,Bahan Masak & Bumbu,360,480,120,53,40,-13,33.33%,
2,1461,Bahan Masak & Bumbu,110,140,30,16,13,-3,27.27%,
2,1465,Bahan Masak & Bumbu,760,960,200,58,46,-12,26.32%,
2,1466,Bahan Masak & Bumbu,40,50,10,5,4,-1,25.00%,
2,1468,Bahan Masak & Bumbu,30,50,20,23,14,-9,66.67%,
2,1469,Bahan Masak & Bumbu,90,100,10,60,54,-6,11.11%,
2,1470,Bahan Masak & Bumbu,30,40,10,1,1,0,33.33%,
2,1471,Bahan Masak & Bumbu,210,270,60,39,31,-8,28.57%,
2,1473,Bahan Masak & Bumbu,120,170,50,57,41,-16,41.67%,
2,1475,Bahan Masak & Bumbu,220,290,70,53,41,-12,31.82%,
2,1476,Bahan Masak & Bumbu,90,110,20,6,5,-1,22.22%,
2,1482,Snack,168,168,0,3,3,0,No,
2,1489,Minuman,288,312,24,32,30,-2,8.33%,
2,1490,Minuman,560,880,320,2,2,0,57.14%,
2,1491,Kebutuhan Pokok,96,96,0,5,5,0,No,
2,1493,Snack,130,130,0,4,4,0,No,
2,1494,Snack,20,20,0,4,4,0,No,
2,1496,Sarapan,156,156,0,1,1,0,No,
2,1500,Bahan Masak & Bumbu,1740,2256,516,90,70,-20,29.66%,
2,1502,Bahan Masak & Bumbu,228,300,72,52,40,-12,31.58%,
2,1503,Bahan Masak & Bumbu,540,684,144,70,56,-14,26.67%,
2,1504,Bahan Masak & Bumbu,408,528,120,74,58,-16,29.41%,
2,1507,Kebutuhan Pokok,654,822,168,1,1,0,25.69%,
2,1515,Tepung & Bahan Kue,864,1440,576,40,24,-16,66.67%,
2,1517,Vitamin,144,144,0,2,2,0,No,
2,1518,Vitamin,240,264,24,52,48,-4,10.00%,
2,1524,,150,250,100,40,24,-16,66.67%,
2,1525,Perawatan Rumah,0,48,48,69,0,-69,100.00%,Yes
2,1526,Perawatan Rumah,300,408,108,71,53,-18,36.00%,
2,1534,Snack,480,648,168,52,39,-13,35.00%,
2,1535,,204,288,84,38,27,-11,41.18%,
2,1539,Alat Tulis Kantor,96,96,0,6,6,0,No,
2,1546,Minuman,96,144,48,1,1,0,50.00%,
2,1554,Vitamin,75,125,50,2,2,0,66.67%,
2,1556,Obat-obatan,468,468,0,12,12,0,No,
2,1578,Perawatan Diri ,288,288,0,11,11,0,No,
2,1582,Perawatan Rumah,648,648,0,15,15,0,No,
2,1584,Makanan & Susu Bayi,0,0,0,5,5,0,No,
2,1585,Makanan & Susu Bayi,0,0,0,32,32,0,No,
2,1587,Makanan & Susu Bayi,0,0,0,18,18,0,No,
2,1603,Kebersihan Badan,276,264,-12,1,2,1,No,
2,1606,Kebersihan Badan,12,36,24,14,5,-9,200.00%,
2,1607,Kebersihan Badan,168,192,24,47,42,-5,14.29%,
2,1609,Kebutuhan Cuci Baju,156,228,72,1,1,0,46.15%,
2,1619,Sarapan,144,192,48,2,2,0,33.33%,
2,1620,Sarapan,72,72,0,1,1,0,No,
2,1623,Perawatan Rumah,396,648,252,9,6,-3,63.64%,
2,1624,Perawatan Rumah,288,516,228,51,29,-22,79.17%,
2,1637,Perawatan Mulut,672,816,144,3,3,0,21.43%,
2,1643,,480,672,192,55,40,-15,40.00%,
2,1649,Perawatan Hewan,24,24,0,1,1,0,No,
2,1651,Kebutuhan Pokok,20,40,20,21,11,-10,100.00%,
2,1665,Minuman,192,336,144,28,16,-12,75.00%,
2,1668,Susu & Olahan Susu,576,816,240,8,6,-2,41.67%,
2,1670,Alat Kesehatan,60,120,60,8,4,-4,100.00%,
2,1672,Sarapan,228,312,84,63,47,-16,36.84%,
2,1676,Bahan Masak & Bumbu,360,360,0,4,4,0,No,
2,1679,Sarapan,48,96,48,7,4,-3,100.00%,
2,1680,Sarapan,100,150,50,14,10,-4,50.00%,
2,1683,Susu & Olahan Susu,120,144,24,4,4,0,20.00%,
2,1697,Minuman,1176,1728,552,1,1,0,46.94%,
2,1698,Minuman,552,864,312,1,1,0,56.52%,
2,1735,Bahan Masak & Bumbu,216,264,48,8,7,-1,22.22%,
2,1736,Bahan Masak & Bumbu,552,552,0,1,1,0,No,
2,1752,Tepung & Bahan Kue,216,300,84,18,13,-5,38.89%,
2,1765,Tepung & Bahan Kue,0,0,0,15,15,0,No,
2,1778,Kebutuhan Cuci Baju,72,72,0,6,6,0,No,
2,1783,Kebutuhan Pokok,400,400,0,44,44,0,No,
2,1784,Kebutuhan Pokok,0,0,0,10,10,0,No,
2,1785,Kebutuhan Pokok,160,280,120,58,34,-24,75.00%,
2,1788,Kebutuhan Pokok,192,192,0,7,7,0,No,
2,1789,Kebutuhan Pokok,0,0,0,1,1,0,No,
2,1794,Kebutuhan Pokok,0,0,0,22,22,0,No,
2,1802,Bahan Masak & Bumbu,0,30,30,36,0,-36,100.00%,Yes
2,1812,Biskuit,80,80,0,37,37,0,No,
2,1814,Bahan Masak & Bumbu,0,0,0,2,2,0,No,
2,1816,Bahan Masak & Bumbu,0,60,60,68,0,-68,100.00%,Yes
2,1818,Bahan Masak & Bumbu,0,120,120,90,0,-90,100.00%,Yes
2,1819,Biskuit,240,240,0,9,9,0,No,
2,1828,Snack,0,0,0,24,24,0,No,
2,1833,Kebutuhan Pokok,0,0,0,188,188,0,No,
2,1896,Biskuit,980,1340,360,18,14,-4,36.73%,
2,1899,Cokelat,0,0,0,44,44,0,No,
2,1900,Kebutuhan Cuci Baju,72,72,0,1,1,0,No,
2,1901,Cokelat,0,0,0,8,8,0,No,
2,1902,Cokelat,0,0,0,18,18,0,No,
2,1914,Kebutuhan Cuci Baju,60,60,0,40,40,0,No,
2,1946,Kebutuhan Ibu & Bayi,60,60,0,6,6,0,No,
2,1947,Kebutuhan Ibu & Bayi,24,36,12,38,26,-12,50.00%,
2,1984,Tepung & Bahan Kue,876,1212,336,16,12,-4,38.36%,
2,1993,Shampoo & Conditioner,84,72,-12,1,2,1,No,
2,2007,Kebutuhan Pokok,17160,17160,0,117,117,0,No,
2,2017,Bahan Masak & Bumbu,1176,1176,0,2,2,0,No,
2,2023,Kebersihan Badan,0,0,0,7,7,0,No,
2,2024,Kebersihan Badan,48,72,24,28,19,-9,50.00%,
2,2026,Obat-obatan,0,0,0,14,14,0,No,
2,2041,Snack,0,0,0,65,65,0,No,
2,2043,Bahan Masak & Bumbu,0,54,54,2,0,-2,100.00%,Yes
2,2046,Snack,0,0,0,1,1,0,No,
2,2060,Snack,0,0,0,19,19,0,No,
2,2061,Snack,180,180,0,3,3,0,No,
2,2064,Bahan Masak & Bumbu,1800,2520,720,1,1,0,40.00%,
2,2065,Bahan Masak & Bumbu,600,768,168,12,10,-2,28.00%,
2,2067,Bahan Masak & Bumbu,120,210,90,24,14,-10,75.00%,
2,2077,Cokelat,0,0,0,196,196,0,No,
2,2079,Cokelat,0,0,0,203,203,0,No,
2,2080,Shampoo & Conditioner,40,60,20,10,7,-3,50.00%,
2,2086,Biskuit,560,640,80,66,58,-8,14.29%,
2,2087,Biskuit,160,160,0,60,60,0,No,
2,2090,Permen,264,264,0,30,30,0,No,
2,2091,Permen,168,192,24,56,49,-7,14.29%,
2,2093,Permen,72,144,72,20,10,-10,100.00%,
2,2094,Permen,192,240,48,49,40,-9,25.00%,
2,2097,Biskuit,432,432,0,19,19,0,No,
2,2099,Biskuit,432,432,0,34,34,0,No,
2,2101,Biskuit,288,288,0,1,1,0,No,
2,2104,Susu & Olahan Susu,816,1080,264,29,22,-7,32.35%,
2,2108,Biskuit,1332,1332,0,11,11,0,No,
2,2109,Biskuit,120,180,60,45,30,-15,50.00%,
2,2110,Biskuit,60,60,0,4,4,0,No,
2,2111,Biskuit,0,180,180,7,0,-7,100.00%,Yes
2,2112,Cokelat,0,0,0,1,1,0,No,
2,2120,Permen,216,240,24,7,7,0,11.11%,
2,2121,Permen,0,0,0,6,6,0,No,
2,2124,Perawatan Diri ,24,24,0,1,1,0,No,
2,2133,Snack,1120,1120,0,2,2,0,No,
2,2149,Bahan Masak & Bumbu,880,1040,160,102,87,-15,18.18%,
2,2162,Kebutuhan Pokok,0,140,140,137,0,-137,100.00%,Yes
2,2168,Obat-obatan,24,60,36,2,1,-1,150.00%,
2,2180,Snack,432,432,0,1,1,0,No,
2,2184,Perawatan Mulut,864,1332,468,50,33,-17,54.17%,
2,2190,Biskuit,1140,1590,450,71,51,-20,39.47%,
2,2191,Minuman,444,552,108,137,111,-26,24.32%,
2,2193,Minuman,60,84,24,9,7,-2,40.00%,
2,2203,Shampoo & Conditioner,36,36,0,7,7,0,No,
2,2204,Shampoo & Conditioner,108,108,0,19,19,0,No,
2,2210,Kebersihan Badan,0,0,0,9,9,0,No,
2,2211,Kebersihan Badan,252,348,96,4,3,-1,38.10%,
2,2217,Minuman,264,336,72,110,87,-23,27.27%,
2,2219,Minuman,24,48,24,13,7,-6,100.00%,
2,2221,Minuman,144,192,48,41,31,-10,33.33%,
2,2222,Minuman,336,408,72,23,19,-4,21.43%,
2,2223,Minuman,648,816,168,69,55,-14,25.93%,
2,2228,Sarapan,120,144,24,34,29,-5,20.00%,
2,2231,Minuman,156,156,0,1,1,0,No,
2,2246,Shampoo & Conditioner,18,18,0,1,1,0,No,
2,2248,Shampoo & Conditioner,54,36,-18,3,5,2,No,
2,2252,Minuman,48,48,0,6,6,0,No,
2,2253,Perawatan Diri ,60,72,12,20,17,-3,20.00%,
2,2267,Sarapan,144,336,192,1,1,0,133.33%,
2,2271,Minuman,996,1512,516,1,1,0,51.81%,
2,2273,Minuman,48,72,24,5,4,-1,50.00%,
2,2286,Minuman,0,0,0,56,56,0,No,
2,2289,Kebersihan Badan,96,96,0,49,49,0,No,
2,2295,Perawatan Diri ,48,48,0,6,6,0,No,
2,2298,Shampoo & Conditioner,0,0,0,12,12,0,No,
2,2300,Shampoo & Conditioner,144,144,0,2,2,0,No,
2,2307,Perawatan Mulut,72,96,24,1,1,0,33.33%,
2,2315,Snack,280,280,0,1,1,0,No,
2,2322,Shampoo & Conditioner,0,0,0,6,6,0,No,
2,2323,Bahan Masak & Bumbu,0,30,30,46,0,-46,100.00%,Yes
2,2325,,144,144,0,29,29,0,No,
2,2326,Snack,120,144,24,46,39,-7,20.00%,
2,2333,Biskuit,1296,1392,96,174,162,-12,7.41%,
2,2342,Susu & Olahan Susu,0,0,0,5,5,0,No,
2,2345,Alat Kesehatan,55,55,0,1,1,0,No,
2,2349,Perawatan Rumah,156,192,36,3,3,0,23.08%,
2,2353,Sarapan,486,684,198,15,11,-4,40.74%,
2,2355,Kebutuhan Pokok,228,288,60,46,37,-9,26.32%,
2,2358,Kebutuhan Pokok,96,144,48,69,46,-23,50.00%,
2,2360,Kebutuhan Pokok,120,180,60,79,53,-26,50.00%,
2,2371,,0,0,0,21,21,0,No,
2,2372,Cokelat,0,0,0,46,46,0,No,
2,2373,Cokelat,0,0,0,55,55,0,No,
2,2388,Produk 21+,140,140,0,1,1,0,No,
2,2400,Minuman,0,0,0,1,1,0,No,
2,2402,Perawatan Diri ,0,48,48,3,0,-3,100.00%,Yes
2,2405,Perawatan Diri ,792,1056,264,5,4,-1,33.33%,
2,2411,Bahan Masak & Bumbu,48,48,0,69,69,0,No,
2,2418,Minuman,120,120,0,2,2,0,No,
2,2421,Minuman,1272,2016,744,8,6,-2,58.49%,
2,2433,Elektronik,144,144,0,4,4,0,No,
2,2434,Minuman,48,48,0,84,84,0,No,
2,2440,Snack,340,440,100,3,3,0,29.41%,
2,2459,Kebutuhan Cuci Baju,0,0,0,14,14,0,No,
2,2460,Elektronik,864,1296,432,203,136,-67,50.00%,
2,2461,Elektronik,432,720,288,203,122,-81,66.67%,
2,2476,Elektronik,0,72,72,59,0,-59,100.00%,Yes
2,2479,Alat Tulis Kantor,0,0,0,18,18,0,No,
2,2484,Snack,0,216,216,67,0,-67,100.00%,Yes
2,2485,Minuman,360,360,0,1,1,0,No,
2,2498,Alat Tulis Kantor,0,0,0,28,28,0,No,
2,2505,Susu & Olahan Susu,168,216,48,5,4,-1,28.57%,
2,2521,Cokelat,0,0,0,46,46,0,No,
2,2525,Elektronik,120,120,0,8,8,0,No,
2,2536,Susu & Olahan Susu,0,0,0,9,9,0,No,
2,2550,Gas & Air Galon,420,420,0,2,2,0,No,
2,2582,Vitamin,900,900,0,21,21,0,No,
2,2590,Perawatan Diri ,432,432,0,35,35,0,No,
2,2603,Biskuit,48,48,0,22,22,0,No,
2,2614,Snack,0,18,18,4,0,-4,100.00%,Yes
2,2619,Sarapan,312,312,0,22,22,0,No,
2,2625,Perawatan Diri ,0,0,0,68,68,0,No,
2,2636,Minuman,120,144,24,43,36,-7,20.00%,
2,2637,Sarapan,144,144,0,3,3,0,No,
2,2673,Sarapan,36,48,12,26,20,-6,33.33%,
2,2674,Susu & Olahan Susu,0,0,0,5,5,0,No,
2,2753,Snack,576,936,360,49,31,-18,62.50%,
2,2754,Snack,648,816,168,9,8,-1,25.93%,
2,2764,Susu & Olahan Susu,264,312,48,13,11,-2,18.18%,
2,2788,Kebersihan Badan,0,0,0,4,4,0,No,
2,2789,Skincare,0,0,0,9,9,0,No,
2,2790,Kebersihan Badan,0,0,0,7,7,0,No,
2,2792,Kebersihan Badan,35,35,0,6,6,0,No,
2,2793,Skincare,30,30,0,4,4,0,No,
2,2803,Obat-obatan,72,72,0,17,17,0,No,
2,2809,Biskuit,20,60,40,65,22,-43,200.00%,
2,2847,Minuman,24,24,0,1,1,0,No,
2,2872,Alat Tulis Kantor,0,120,120,3,0,-3,100.00%,Yes
2,2873,Sarapan,423,549,126,112,87,-25,29.79%,
2,2874,Sarapan,1179,1539,360,176,135,-41,30.53%,
2,2875,Sarapan,250,325,75,15,12,-3,30.00%,
2,2876,Sarapan,732,972,240,10,8,-2,32.79%,
2,2878,Susu & Olahan Susu,168,200,32,13,11,-2,19.05%,
2,2879,Susu & Olahan Susu,0,0,0,1,1,0,No,
2,2887,Makanan & Susu Bayi,132,204,72,19,13,-6,54.55%,
2,2888,Makanan & Susu Bayi,156,252,96,32,20,-12,61.54%,
2,2902,Snack,360,360,0,1,1,0,No,
2,2906,Kebutuhan Cuci Baju,600,1008,408,41,25,-16,68.00%,
2,2909,Alat Tulis Kantor,456,624,168,9,7,-2,36.84%,
2,2910,Sarapan,156,204,48,74,57,-17,30.77%,
2,2920,Tepung & Bahan Kue,0,0,0,3,3,0,No,
2,2925,Tepung & Bahan Kue,0,0,0,19,19,0,No,
2,2944,Bahan Masak & Bumbu,144,216,72,5,4,-1,50.00%,
2,2973,Minuman,90,130,40,70,49,-21,44.44%,
2,2997,Perlengkapan Pesta,350,379,29,171,158,-13,8.29%,
2,3000,Kebutuhan Pokok,576,696,120,1,1,0,20.83%,
2,3001,Snack,0,0,0,79,79,0,No,
2,3006,,0,0,0,25,25,0,No,
2,3035,Sarapan,240,420,180,11,7,-4,75.00%,
2,3036,Sarapan,200,220,20,64,59,-5,10.00%,
2,3037,Sarapan,80,100,20,41,33,-8,25.00%,
2,3056,Sarapan,72,72,0,7,7,0,No,
2,3107,Tata Rumah,0,0,0,30,30,0,No,
2,3119,Kebutuhan Pokok,0,0,0,38,38,0,No,
2,3135,Cokelat,0,0,0,1,1,0,No,
2,3141,Biskuit,552,576,24,174,167,-7,4.35%,
2,3142,Biskuit,864,1032,168,174,146,-28,19.44%,
2,3344,Alat Tulis Kantor,320,320,0,31,31,0,No,
2,3353,Biskuit,708,972,264,92,68,-24,37.29%,
2,3354,Cokelat,0,0,0,152,152,0,No,
2,3367,Bahan Masak & Bumbu,48,72,24,27,18,-9,50.00%,
2,3400,Sarapan,300,552,252,2,2,0,84.00%,
2,3432,Biskuit,96,120,24,66,53,-13,25.00%,
2,3433,Biskuit,192,288,96,58,39,-19,50.00%,
2,3496,Snack,0,0,0,1,1,0,No,
2,3541,Permen,96,120,24,74,60,-14,25.00%,
2,3598,Fashion Aksesoris,0,0,0,4,4,0,No,
2,3643,Sarapan,264,456,192,32,19,-13,72.73%,
2,3673,Snack,144,144,0,10,10,0,No,
2,3675,Snack,192,240,48,57,46,-11,25.00%,
2,3676,Snack,384,432,48,73,65,-8,12.50%,
2,3692,Minuman,48,60,12,1,1,0,25.00%,
2,3706,Obat-obatan,36,48,12,20,15,-5,33.33%,
2,3709,Vitamin,0,0,0,43,43,0,No,
2,3732,Biskuit,280,360,80,68,53,-15,28.57%,
2,3786,Perawatan Diri ,0,0,0,50,50,0,No,
2,3810,Perawatan Diri ,27,27,0,1,1,0,No,
2,3813,Make Up,20,27,7,12,9,-3,35.00%,
2,3829,Tata Rumah,360,360,0,2,2,0,No,
2,3856,Susu & Olahan Susu,0,0,0,39,39,0,No,
2,3858,Susu & Olahan Susu,72,72,0,8,8,0,No,
2,3859,Susu & Olahan Susu,96,120,24,60,48,-12,25.00%,
2,3913,Sarapan,528,720,192,20,15,-5,36.36%,
2,3918,Bahan Masak & Bumbu,0,0,0,3,3,0,No,
2,3920,,288,432,144,26,18,-8,50.00%,
2,3988,Snack,0,0,0,14,14,0,No,
2,3993,Snack,90,120,30,19,15,-4,33.33%,
2,4020,Kebutuhan Pokok,133,184,51,64,47,-17,38.35%,
2,4022,Kebutuhan Pokok,228,320,92,141,101,-40,40.35%,
2,4023,Sarapan,0,0,0,5,5,0,No,
2,4113,Minuman,948,1164,216,139,114,-25,22.78%,
2,4127,Kebutuhan Pokok,420,420,0,50,50,0,No,
2,4141,Kebersihan Badan,156,156,0,6,6,0,No,
2,4142,Kebersihan Badan,72,72,0,6,6,0,No,
2,4146,Kebersihan Badan,384,468,84,58,48,-10,21.88%,
2,4153,Shampoo & Conditioner,312,336,24,160,149,-11,7.69%,
2,4154,Shampoo & Conditioner,0,0,0,162,162,0,No,
2,4155,Perawatan Diri ,240,240,0,51,51,0,No,
2,4159,Shampoo & Conditioner,0,0,0,2,2,0,No,
2,4181,Kebutuhan Ibu & Bayi,0,0,0,10,10,0,No,
2,4184,Kebutuhan Ibu & Bayi,0,0,0,9,9,0,No,
2,4200,Susu & Olahan Susu,0,0,0,2,2,0,No,
2,4202,Susu & Olahan Susu,0,0,0,10,10,0,No,
2,4203,Susu & Olahan Susu,0,0,0,4,4,0,No,
2,4222,Bahan Masak & Bumbu,360,360,0,69,69,0,No,
2,4224,Bahan Masak & Bumbu,180,180,0,16,16,0,No,
2,4227,Perawatan Mulut,96,96,0,7,7,0,No,
2,4239,Minuman,160,200,40,16,13,-3,25.00%,
2,4240,Obat-obatan,0,0,0,6,6,0,No,
2,4277,Alat Kesehatan,78,78,0,13,13,0,No,
2,4305,Kebutuhan Dapur,48,48,0,5,5,0,No,
2,4315,Gas & Air Galon,0,0,0,9,9,0,No,
2,4320,Kebutuhan Pokok,0,0,0,1,1,0,No,
2,4344,Makanan & Susu Bayi,0,0,0,9,9,0,No,
2,4345,Makanan & Susu Bayi,0,0,0,13,13,0,No,
2,4347,Makanan & Susu Bayi,120,144,24,152,127,-25,20.00%,
2,4352,Obat-obatan,0,0,0,48,48,0,No,
2,4355,Obat-obatan,96,96,0,2,2,0,No,
2,4357,Snack,0,0,0,31,31,0,No,
2,4384,Snack,240,240,0,28,28,0,No,
2,4395,Perawatan Hewan,96,144,48,12,8,-4,50.00%,
2,4414,Otomotif,24,24,0,1,1,0,No,
2,4428,Obat-obatan,576,576,0,3,3,0,No,
2,4447,Snack,180,540,360,103,35,-68,200.00%,
2,4449,Snack,270,630,360,10,5,-5,133.33%,
2,4451,Snack,0,0,0,95,95,0,No,
2,4452,Snack,90,90,0,6,6,0,No,
2,4454,Makanan & Susu Bayi,24,24,0,2,2,0,No,
2,4457,Minuman,840,1104,264,3,3,0,31.43%,
2,4459,Minuman,168,264,96,46,30,-16,57.14%,
2,4461,Minuman,48,48,0,17,17,0,No,
2,4462,Minuman,24,144,120,71,12,-59,500.00%,
2,4467,Makanan & Susu Bayi,0,0,0,16,16,0,No,
2,4468,Makanan & Susu Bayi,12,24,12,9,5,-4,100.00%,
2,4471,Makanan & Susu Bayi,72,120,48,15,9,-6,66.67%,
2,4487,Minuman,750,750,0,1,1,0,No,
2,4489,Makanan & Susu Bayi,0,12,12,16,0,-16,100.00%,Yes
2,4490,Makanan & Susu Bayi,84,108,24,19,15,-4,28.57%,
2,4495,Obat-obatan,432,504,72,54,47,-7,16.67%,
2,4497,Obat-obatan,72,144,72,11,6,-5,100.00%,
2,4498,,144,180,36,83,67,-16,25.00%,
2,4516,Sarapan,24,24,0,26,26,0,No,
2,4529,Biskuit,120,168,48,84,60,-24,40.00%,
2,4533,Biskuit,252,360,108,93,66,-27,42.86%,
2,4534,Biskuit,48,48,0,56,56,0,No,
2,4536,Bahan Masak & Bumbu,0,0,0,4,4,0,No,
2,4542,Bahan Masak & Bumbu,1920,2400,480,30,24,-6,25.00%,
2,4574,Sarapan,36,36,0,12,12,0,No,
2,4586,Sarapan,48,60,12,36,29,-7,25.00%,
2,4589,Kebutuhan Pokok,48,60,12,15,12,-3,25.00%,
2,4594,Snack,72,72,0,11,11,0,No,
2,4625,,102,156,54,14,10,-4,52.94%,
2,4655,Kebersihan Badan,120,120,0,46,46,0,No,
2,4656,Kebersihan Badan,96,120,24,30,24,-6,25.00%,
2,4679,Obat-obatan,96,120,24,22,18,-4,25.00%,
2,4681,Perawatan Rumah,360,480,120,4,3,-1,33.33%,
2,4692,,72,108,36,31,21,-10,50.00%,
2,4708,Kebersihan Badan,90,96,6,7,7,0,6.67%,
2,4720,Perawatan Rumah,880,880,0,2,2,0,No,
2,4727,Minuman,792,1416,624,8,5,-3,78.79%,
2,4728,Minuman,468,1044,576,1,1,0,123.08%,
2,4735,Biskuit,408,552,144,1,1,0,35.29%,
2,4736,Sarapan,0,144,144,12,0,-12,100.00%,Yes
2,4737,Biskuit,216,336,120,18,12,-6,55.56%,
2,4738,Biskuit,0,0,0,21,21,0,No,
2,4743,Permen,120,120,0,7,7,0,No,
2,4746,Kebutuhan Pokok,30,30,0,5,5,0,No,
2,4802,Bahan Masak & Bumbu,192,228,36,162,137,-25,18.75%,
2,4817,Tepung & Bahan Kue,216,216,0,3,3,0,No,
2,4818,Tepung & Bahan Kue,144,180,36,55,44,-11,25.00%,
2,4819,Tepung & Bahan Kue,0,108,108,102,0,-102,100.00%,Yes
2,4872,Kebutuhan Pokok,324,396,72,104,86,-18,22.22%,
2,4876,Vitamin,24,24,0,13,13,0,No,
2,4879,Snack,400,550,150,26,19,-7,37.50%,
2,4922,,0,0,0,52,52,0,No,
2,4924,Perawatan Rumah,108,168,60,8,6,-2,55.56%,
2,4942,Susu & Olahan Susu,0,0,0,133,133,0,No,
2,4943,Susu & Olahan Susu,0,0,0,189,189,0,No,
2,4945,Snack,216,276,60,18,15,-3,27.78%,
2,4958,Susu & Olahan Susu,0,0,0,203,203,0,No,
2,4986,Kebutuhan Ibu & Bayi,0,0,0,8,8,0,No,
2,4987,Kebutuhan Ibu & Bayi,0,0,0,25,25,0,No,
2,5030,Bahan Masak & Bumbu,192,384,192,30,15,-15,100.00%,
2,5057,Susu & Olahan Susu,456,600,144,25,19,-6,31.58%,
2,5058,Susu & Olahan Susu,288,420,132,82,57,-25,45.83%,
2,5065,Obat-obatan,456,552,96,165,137,-28,21.05%,
2,5073,Make Up,108,132,24,61,50,-11,22.22%,
2,5074,Makanan & Susu Bayi,0,0,0,15,15,0,No,
2,5075,Makanan & Susu Bayi,0,0,0,21,21,0,No,
2,5078,Makanan & Susu Bayi,0,0,0,18,18,0,No,
2,5097,Bahan Masak & Bumbu,1152,1536,384,27,21,-6,33.33%,
2,5099,Obat-obatan,0,0,0,3,3,0,No,
2,5107,Susu & Olahan Susu,0,0,0,1,1,0,No,
2,5122,Susu & Olahan Susu,0,0,0,3,3,0,No,
2,5123,Susu & Olahan Susu,96,96,0,33,33,0,No,
2,5131,Snack,30,30,0,23,23,0,No,
2,5132,Snack,90,90,0,34,34,0,No,
2,5133,Snack,0,0,0,23,23,0,No,
2,5136,Kebutuhan Ibu & Bayi,0,0,0,59,59,0,No,
2,5162,Snack,78,78,0,9,9,0,No,
2,5163,,66,78,12,27,23,-4,18.18%,
2,5211,Bahan Masak & Bumbu,24,48,24,65,33,-32,100.00%,
2,5212,Bahan Masak & Bumbu,56,85,29,12,8,-4,51.79%,
2,5363,Snack,0,0,0,9,9,0,No,
2,5364,Snack,60,90,30,43,29,-14,50.00%,
2,5366,Snack,90,90,0,30,30,0,No,
2,5367,Snack,210,210,0,13,13,0,No,
2,5368,Obat-obatan,36,36,0,6,6,0,No,
2,5376,Cokelat,0,0,0,9,9,0,No,
2,5377,Cokelat,0,0,0,1,1,0,No,
2,5419,Biskuit,48,72,24,21,14,-7,50.00%,
2,5420,Makanan & Susu Bayi,132,132,0,19,19,0,No,
2,5421,Makanan & Susu Bayi,132,156,24,13,11,-2,18.18%,
2,5434,Bahan Masak & Bumbu,0,0,0,31,31,0,No,
2,5439,Perawatan Hewan,108,132,24,60,50,-10,22.22%,
2,5476,Sarapan,60,96,36,78,49,-29,60.00%,
2,5480,Cokelat,0,0,0,2,2,0,No,
2,5505,Kebutuhan Cuci Baju,0,0,0,22,22,0,No,
2,5541,Perawatan Mulut,36,36,0,2,2,0,No,
2,5542,Perawatan Mulut,96,96,0,17,17,0,No,
2,5545,Perawatan Diri ,336,432,96,1,1,0,28.57%,
2,5610,Sarapan,72,84,12,40,35,-5,16.67%,
2,5657,Sarapan,160,220,60,3,3,0,37.50%,
2,5674,Susu & Olahan Susu,0,0,0,13,13,0,No,
2,5689,Bahan Masak & Bumbu,60,120,60,46,23,-23,100.00%,
2,5700,Snack,852,972,120,33,29,-4,14.08%,
2,5706,Bahan Masak & Bumbu,0,0,0,210,210,0,No,
2,5711,Kebutuhan Ibu & Bayi,0,0,0,1,1,0,No,
2,5731,Snack,390,510,120,42,33,-9,30.77%,
2,5748,Kebersihan Wajah,264,336,72,49,39,-10,27.27%,
2,5750,Kebersihan Wajah,72,72,0,20,20,0,No,
2,5778,Biskuit,420,540,120,6,5,-1,28.57%,
2,5836,Snack,54,66,12,6,5,-1,22.22%,
2,5870,Otomotif,24,24,0,1,1,0,No,
2,5898,Makanan & Susu Bayi,132,156,24,6,6,0,18.18%,
2,5899,Makanan & Susu Bayi,0,0,0,2,2,0,No,
2,5909,Snack,92,138,46,3,2,-1,50.00%,
2,5915,Snack,128,108,-20,14,17,3,No,
2,5952,Minuman,0,0,0,4,4,0,No,
2,5959,Minuman,0,0,0,75,75,0,No,
2,5960,Minuman,0,0,0,112,112,0,No,
2,5973,Obat-obatan,0,0,0,5,5,0,No,
2,5983,Susu & Olahan Susu,240,288,48,21,18,-3,20.00%,
2,6000,Snack,592,656,64,7,7,0,10.81%,
2,6009,Makanan & Susu Bayi,0,0,0,72,72,0,No,
2,6013,Perawatan Rumah,108,168,60,2,2,0,55.56%,
2,6017,Makanan & Susu Bayi,0,0,0,11,11,0,No,
2,6019,Makanan & Susu Bayi,0,0,0,7,7,0,No,
2,6022,Makanan & Susu Bayi,80,120,40,9,6,-3,50.00%,
2,6054,Vitamin,0,50,50,10,0,-10,100.00%,Yes
2,6118,Alat Kesehatan,100,100,0,21,21,0,No,
2,6119,Alat Kesehatan,0,0,0,1,1,0,No,
2,6131,Produk 21+,470,470,0,2,2,0,No,
2,6176,Kebutuhan Cuci Baju,492,660,168,124,93,-31,34.15%,
2,6181,Minuman,24,48,24,27,14,-13,100.00%,
2,6187,Minuman,192,288,96,9,6,-3,50.00%,
2,6188,Minuman,768,792,24,131,128,-3,3.13%,
2,6189,Minuman,1044,1380,336,99,75,-24,32.18%,
2,6194,Sarapan,0,0,0,13,13,0,No,
2,6196,Sarapan,120,120,0,5,5,0,No,
2,6199,Biskuit,2560,3280,720,114,89,-25,28.13%,
2,6200,Biskuit,3204,4068,864,30,24,-6,26.97%,
2,6208,Minuman,576,768,192,15,12,-3,33.33%,
2,6210,Sarapan,96,96,0,7,7,0,No,
2,6214,Sarapan,264,264,0,6,6,0,No,
2,6263,Snack,948,948,0,12,12,0,No,
2,6264,Snack,240,240,0,33,33,0,No,
2,6285,Vitamin,0,0,0,49,49,0,No,
2,6296,Biskuit,0,20,20,19,0,-19,100.00%,Yes
2,6298,Sarapan,180,250,70,4,3,-1,38.89%,
2,6299,Snack,252,240,-12,5,6,1,No,
2,6311,Bahan Masak & Bumbu,120,120,0,1,1,0,No,
2,6344,Susu & Olahan Susu,60,120,60,1,1,0,100.00%,
2,6365,Perawatan Rumah,132,132,0,2,2,0,No,
2,6491,Susu & Olahan Susu,0,0,0,25,25,0,No,
2,6492,Susu & Olahan Susu,0,0,0,13,13,0,No,
2,6494,Susu & Olahan Susu,0,0,0,25,25,0,No,
2,6513,Minuman,1152,1152,0,2,2,0,No,
2,6515,Bahan Masak & Bumbu,1100,1700,600,25,17,-8,54.55%,
2,6518,Bahan Masak & Bumbu,1560,1920,360,28,23,-5,23.08%,
2,6520,Bahan Masak & Bumbu,768,960,192,10,8,-2,25.00%,
2,6539,Bahan Masak & Bumbu,30,60,30,7,4,-3,100.00%,
2,6545,Kebutuhan Ibu & Bayi,12,12,0,1,1,0,No,
2,6547,Kebutuhan Ibu & Bayi,44,64,20,13,9,-4,45.45%,
2,6554,Biskuit,0,0,0,21,21,0,No,
2,6555,Biskuit,180,180,0,25,25,0,No,
2,6561,Sarapan,288,378,90,3,3,0,31.25%,
2,6563,Cokelat,0,0,0,11,11,0,No,
2,6566,Cokelat,0,0,0,44,44,0,No,
2,6567,Cokelat,0,0,0,39,39,0,No,
2,6569,Cokelat,0,0,0,25,25,0,No,
2,6570,Sarapan,0,0,0,3,3,0,No,
2,6573,Biskuit,80,80,0,16,16,0,No,
2,6578,Snack,306,756,450,68,28,-40,147.06%,
2,6582,Snack,480,690,210,1,1,0,43.75%,
2,6587,Kebutuhan Ibu & Bayi,96,96,0,6,6,0,No,
2,6589,Minuman,756,756,0,4,4,0,No,
2,6591,Minuman,744,744,0,9,9,0,No,
2,6595,Makanan & Susu Bayi,6,12,6,14,7,-7,100.00%,
2,6601,Snack,0,0,0,1,1,0,No,
2,6608,Snack,36,72,36,25,13,-12,100.00%,
2,6614,Kebutuhan Ibu & Bayi,60,60,0,2,2,0,No,
2,6646,Minuman,840,1632,792,7,4,-3,94.29%,
2,6647,Minuman,48,48,0,1,1,0,No,
2,6649,Susu & Olahan Susu,1116,1476,360,30,23,-7,32.26%,
2,6657,Sarapan,300,350,50,18,16,-2,16.67%,
2,6661,Sarapan,72,72,0,19,19,0,No,
2,6710,Susu & Olahan Susu,72,96,24,5,4,-1,33.33%,
2,6724,Bahan Masak & Bumbu,120,216,96,2,2,0,80.00%,
2,6738,Sarapan,0,0,0,7,7,0,No,
2,6765,Bahan Masak & Bumbu,210,210,0,43,43,0,No,
2,6780,Bahan Masak & Bumbu,30,30,0,4,4,0,No,
2,6786,Perawatan Rumah,216,276,60,2,2,0,27.78%,
2,6791,Perawatan Rumah,273,366,93,3,3,0,34.07%,
2,6807,Biskuit,72,120,48,16,10,-6,66.67%,
2,6815,Snack,72,48,-24,2,3,1,No,
2,6816,Snack,156,192,36,25,21,-4,23.08%,
2,6822,Tepung & Bahan Kue,60,60,0,5,5,0,No,
2,6823,Tepung & Bahan Kue,0,0,0,2,2,0,No,
2,6846,Susu & Olahan Susu,0,0,0,16,16,0,No,
2,6865,Alat Kesehatan,144,192,48,1,1,0,33.33%,
2,6871,Snack,96,70,-26,14,20,6,No,
2,6872,Biskuit,456,600,144,71,54,-17,31.58%,
2,6873,Biskuit,48,96,48,65,33,-32,100.00%,
2,6880,Kebutuhan Pokok,352,352,0,2,2,0,No,
2,6899,Bahan Masak & Bumbu,240,288,48,29,25,-4,20.00%,
2,6904,Tepung & Bahan Kue,130,130,0,1,1,0,No,
2,6932,Skincare,0,0,0,35,35,0,No,
2,6933,Kebersihan Wajah,0,96,96,150,0,-150,100.00%,Yes
2,6956,Susu & Olahan Susu,348,420,72,6,5,-1,20.69%,
2,6959,Kebutuhan Cuci Baju,108,108,0,3,3,0,No,
2,6963,Tepung & Bahan Kue,276,372,96,82,61,-21,34.78%,
2,6966,Kebutuhan Ibu & Bayi,108,124,16,28,25,-3,14.81%,
2,6982,Perawatan Mulut,744,864,120,41,36,-5,16.13%,
2,7058,Snack,0,0,0,6,6,0,No,
2,7068,Bahan Masak & Bumbu,1584,2112,528,30,23,-7,33.33%,
2,7069,,190,220,30,5,5,0,15.79%,
2,7072,Shampoo & Conditioner,660,744,84,12,11,-1,12.73%,
2,7073,Shampoo & Conditioner,288,324,36,29,26,-3,12.50%,
2,7122,Gas & Air Galon,0,0,0,19,19,0,No,
2,7124,Sarapan,504,612,108,194,160,-34,21.43%,
2,7153,Kebersihan Badan,60,84,24,28,20,-8,40.00%,
2,7258,Susu & Olahan Susu,0,0,0,5,5,0,No,
2,7272,Tepung & Bahan Kue,60,72,12,11,10,-1,20.00%,
2,7282,Biskuit,288,360,72,78,63,-15,25.00%,
2,7293,Bahan Masak & Bumbu,660,840,180,47,37,-10,27.27%,
2,7469,Perawatan Rumah,132,192,60,84,58,-26,45.45%,
2,7654,Snack,270,270,0,11,11,0,No,
2,7782,Makanan & Susu Bayi,84,168,84,1,1,0,100.00%,
2,7783,Minuman,216,264,48,8,7,-1,22.22%,
2,7941,Kebutuhan Cuci Baju,0,0,0,12,12,0,No,
2,7942,Kebutuhan Cuci Baju,72,84,12,11,10,-1,16.67%,
2,7943,Kebutuhan Cuci Baju,150,174,24,1,1,0,16.00%,
2,8128,Snack,72,72,0,4,4,0,No,
2,8136,Kebutuhan Dapur,0,0,0,10,10,0,No,
2,8166,,1400,1400,0,1,1,0,No,
2,8227,Kebersihan Badan,48,72,24,14,10,-4,50.00%,
2,8230,Susu & Olahan Susu,0,0,0,28,28,0,No,
2,8234,Kebutuhan Pokok,4160,6800,2640,11,7,-4,63.46%,
2,8291,Snack,24,24,0,36,36,0,No,
2,8327,Sarapan,108,120,12,22,20,-2,11.11%,
2,8338,Alat Kesehatan,84,84,0,1,1,0,No,
2,8465,Snack,120,160,40,56,42,-14,33.33%,
2,8479,Kebutuhan Ibu & Bayi,24,24,0,2,2,0,No,
2,8589,Minuman,0,0,0,67,67,0,No,
2,8711,Makanan & Susu Bayi,0,80,80,37,0,-37,100.00%,Yes
2,8741,Perawatan Rumah,0,0,0,2,2,0,No,
2,8746,Snack,700,780,80,11,10,-1,11.43%,
2,8747,Snack,510,560,50,6,6,0,9.80%,
2,8757,Susu & Olahan Susu,0,0,0,62,62,0,No,
2,8784,Makanan & Susu Bayi,48,72,24,40,27,-13,50.00%,
2,8785,Makanan & Susu Bayi,72,120,48,19,12,-7,66.67%,
2,8790,Kebutuhan Ibu & Bayi,0,0,0,1,1,0,No,
2,8791,Kebutuhan Ibu & Bayi,56,72,16,2,2,0,28.57%,
2,8860,Bahan Masak & Bumbu,60,70,10,7,6,-1,16.67%,
2,8895,Perlengkapan Pakaian ,60,60,0,3,3,0,No,
2,8902,Bahan Masak & Bumbu,1776,2448,672,19,14,-5,37.84%,
2,8917,Kebutuhan Cuci Baju,0,0,0,6,6,0,No,
2,8930,Makanan & Susu Bayi,0,24,24,18,0,-18,100.00%,Yes
2,8932,Makanan & Susu Bayi,120,160,40,36,27,-9,33.33%,
2,8935,Susu & Olahan Susu,135,135,0,3,3,0,No,
2,8969,Makanan & Susu Bayi,12,36,24,24,8,-16,200.00%,
2,8987,Makanan & Susu Bayi,336,324,-12,12,13,1,No,
2,9085,Kebutuhan Ibu & Bayi,156,192,36,22,18,-4,23.08%,
2,9124,,0,0,0,49,49,0,No,
2,9172,Kebutuhan Pokok,60,72,12,7,6,-1,20.00%,
2,9207,Kebutuhan Pokok,180,280,100,157,101,-56,55.56%,
2,9230,Perawatan Diri ,1008,1200,192,163,137,-26,19.05%,
2,9231,Perawatan Diri ,864,1056,192,131,108,-23,22.22%,
2,9304,,0,0,0,4,4,0,No,
2,9343,Biskuit,126,162,36,137,107,-30,28.57%,
2,9371,Sarapan,300,300,0,20,20,0,No,
2,9569,Alat Kesehatan,168,336,168,4,2,-2,100.00%,
2,9570,Alat Kesehatan,0,0,0,1,1,0,No,
2,9649,Alat Kesehatan,57,57,0,3,3,0,No,
2,9651,Alat Kesehatan,56,64,8,10,9,-1,14.29%,
2,9729,Biskuit,30,30,0,15,15,0,No,
2,9776,Perawatan Rumah,60,60,0,33,33,0,No,
2,9778,Kebutuhan Cuci Baju,132,156,24,11,10,-1,18.18%,
2,9945,Kebutuhan Ibu & Bayi,48,60,12,3,3,0,25.00%,
2,9949,Kebutuhan Ibu & Bayi,0,0,0,56,56,0,No,
2,9956,Kebutuhan Cuci Baju,240,240,0,2,2,0,No,
2,9957,Kebutuhan Cuci Baju,0,0,0,1,1,0,No,
2,9962,Perawatan Rumah,0,0,0,8,8,0,No,
2,10061,Perawatan Rumah,336,480,144,14,10,-4,42.86%,
2,10230,Perawatan Mulut,0,0,0,15,15,0,No,
2,10280,Bahan Masak & Bumbu,312,312,0,6,6,0,No,
2,10348,Biskuit,132,168,36,70,55,-15,27.27%,
2,10361,Kebersihan Badan,48,72,24,5,4,-1,50.00%,
2,10377,Shampoo & Conditioner,0,0,0,2,2,0,No,
2,10410,Perawatan Mulut,0,0,0,1,1,0,No,
2,10418,Perawatan Mulut,36,36,0,5,5,0,No,
2,10601,Kebersihan Badan,0,24,24,2,0,-2,100.00%,Yes
2,10620,Vitamin,0,0,0,78,78,0,No,
2,10758,Perawatan Hewan,96,96,0,6,6,0,No,
2,10760,Vitamin,72,72,0,18,18,0,No,
2,10782,Shampoo & Conditioner,17,17,0,1,1,0,No,
2,10822,Kebutuhan Ibu & Bayi,0,0,0,1,1,0,No,
2,10828,Kebutuhan Ibu & Bayi,0,0,0,7,7,0,No,
2,10854,Kebutuhan Ibu & Bayi,72,84,12,1,1,0,16.67%,
2,10855,Kebutuhan Ibu & Bayi,0,0,0,6,6,0,No,
2,10868,Sarapan,100,100,0,35,35,0,No,
2,10894,Vitamin,48,72,24,15,10,-5,50.00%,
2,10895,Vitamin,120,144,24,15,13,-2,20.00%,
2,10912,Minuman,168,216,48,54,42,-12,28.57%,
2,10934,Sarapan,0,48,48,147,0,-147,100.00%,Yes
2,10951,Kebutuhan Ibu & Bayi,119,128,9,63,59,-4,7.56%,
2,10963,Kebersihan Badan,22,22,0,3,3,0,No,
2,10965,Kebutuhan Ibu & Bayi,0,9,9,34,0,-34,100.00%,Yes
2,10966,Kebutuhan Ibu & Bayi,0,0,0,37,37,0,No,
2,11263,Perawatan Diri ,168,192,24,10,9,-1,14.29%,
2,11278,Kebutuhan Cuci Baju,90,102,12,15,14,-1,13.33%,
2,11315,Minuman,696,948,252,5,4,-1,36.21%,
2,11320,Minuman,48,120,72,1,1,0,150.00%,
2,11328,Minuman,240,312,72,17,14,-3,30.00%,
2,11368,Snack,575,775,200,70,52,-18,34.78%,
2,11385,Kebutuhan Dapur,72,84,12,10,9,-1,16.67%,
2,11398,Kebutuhan Dapur,24,36,12,15,10,-5,50.00%,
2,11401,Bahan Masak & Bumbu,240,240,0,142,142,0,No,
2,11405,Bahan Masak & Bumbu,480,480,0,140,140,0,No,
2,11429,Kebutuhan Ibu & Bayi,28,28,0,2,2,0,No,
2,11433,Kebutuhan Ibu & Bayi,36,72,36,9,5,-4,100.00%,
2,11434,Kebutuhan Ibu & Bayi,0,0,0,12,12,0,No,
2,11436,Kebutuhan Ibu & Bayi,8,8,0,1,1,0,No,
2,11439,Kebutuhan Ibu & Bayi,0,0,0,8,8,0,No,
2,11441,Kebutuhan Ibu & Bayi,0,24,24,92,0,-92,100.00%,Yes
2,11442,Kebutuhan Ibu & Bayi,36,44,8,16,14,-2,22.22%,
2,11467,Snack,80,80,0,4,4,0,No,
2,11483,Perawatan Hewan,0,0,0,11,11,0,No,
2,11484,Perawatan Hewan,0,0,0,4,4,0,No,
2,11486,Perawatan Hewan,72,72,0,6,6,0,No,
2,11488,Perawatan Hewan,180,180,0,109,109,0,No,
2,11497,Skincare,48,57,9,2,2,0,18.75%,
2,11507,Kebutuhan Ibu & Bayi,24,36,12,9,6,-3,50.00%,
2,11511,Kebutuhan Ibu & Bayi,0,0,0,9,9,0,No,
2,11524,Permen,0,0,0,5,5,0,No,
2,11540,Minuman,0,72,72,20,0,-20,100.00%,Yes
2,11568,Kebutuhan Ibu & Bayi,24,24,0,6,6,0,No,
2,11581,Kebutuhan Ibu & Bayi,68,68,0,1,1,0,No,
2,11582,Kebutuhan Pokok,12,24,12,6,3,-3,100.00%,
2,11589,Kebutuhan Cuci Baju,36,54,18,19,13,-6,50.00%,
2,11594,Kebutuhan Cuci Baju,6,6,0,1,1,0,No,
2,11599,Kebutuhan Cuci Baju,0,0,0,2,2,0,No,
2,11606,Kebutuhan Cuci Baju,168,276,108,1,1,0,64.29%,
2,11609,Kebutuhan Cuci Baju,0,0,0,2,2,0,No,
2,11611,Kebutuhan Cuci Baju,42,42,0,1,1,0,No,
2,11612,Kebutuhan Cuci Baju,60,72,12,21,18,-3,20.00%,
2,11614,Kebutuhan Cuci Baju,60,72,12,16,14,-2,20.00%,
2,11618,Kebutuhan Cuci Baju,36,36,0,15,15,0,No,
2,11761,Alat Kesehatan,0,0,0,7,7,0,No,
2,11779,Kebutuhan Cuci Baju,0,90,90,8,0,-8,100.00%,Yes
2,11783,Kebutuhan Cuci Baju,30,48,18,13,9,-4,60.00%,
2,11784,Kebutuhan Cuci Baju,48,96,48,5,3,-2,100.00%,
2,11789,Kebutuhan Cuci Baju,6,66,60,38,4,-34,1000.00%,
2,11790,Kebutuhan Cuci Baju,144,240,96,99,60,-39,66.67%,
2,11795,Biskuit,0,0,0,27,27,0,No,
2,11867,Vitamin,6,6,0,6,6,0,No,
2,11871,Sarapan,162,198,36,18,15,-3,22.22%,
2,11934,Tepung & Bahan Kue,288,189,-99,30,46,16,No,
2,11961,Bahan Masak & Bumbu,0,0,0,4,4,0,No,
2,11966,Bahan Masak & Bumbu,89,157,68,3,2,-1,76.40%,
2,11967,Bahan Masak & Bumbu,480,720,240,16,11,-5,50.00%,
2,11969,Bahan Masak & Bumbu,0,80,80,5,0,-5,100.00%,Yes
2,11971,Bahan Masak & Bumbu,28,84,56,26,9,-17,200.00%,
2,11993,Bahan Masak & Bumbu,30,88,58,70,24,-46,193.33%,
2,12006,Kebutuhan Pokok,534,591,57,44,40,-4,10.67%,
2,12008,Tepung & Bahan Kue,0,0,0,43,43,0,No,
2,12062,Snack,128,128,0,27,27,0,No,
2,12067,Snack,24,24,0,8,8,0,No,
2,12073,Snack,168,168,0,26,26,0,No,
2,12074,Snack,216,264,48,28,23,-5,22.22%,
2,12124,Perawatan Diri ,126,168,42,6,5,-1,33.33%,
2,12136,Perawatan Diri ,504,504,0,1,1,0,No,
2,12147,Bahan Masak & Bumbu,312,432,120,112,81,-31,38.46%,
2,12191,Biskuit,108,132,24,53,44,-9,22.22%,
2,12259,Biskuit,0,0,0,16,16,0,No,
2,12307,Biskuit,144,144,0,8,8,0,No,
2,12308,Biskuit,192,224,32,4,4,0,16.67%,
2,12318,Biskuit,0,0,0,1,1,0,No,
2,12337,Biskuit,60,60,0,29,29,0,No,
2,12338,Biskuit,60,60,0,65,65,0,No,
2,12451,Kebersihan Wajah,24,48,24,48,24,-24,100.00%,
2,12452,Make Up,18,23,5,24,19,-5,27.78%,
2,12466,Perawatan Diri ,32,32,0,1,1,0,No,
2,12467,Perawatan Diri ,0,0,0,1,1,0,No,
2,12508,Perawatan Mulut,252,300,48,5,5,0,19.05%,
2,12553,Obat-obatan,0,0,0,73,73,0,No,
2,12640,Snack,400,440,40,39,36,-3,10.00%,
2,12643,Kebutuhan Pokok,0,0,0,14,14,0,No,
2,12644,Kebutuhan Pokok,0,0,0,25,25,0,No,
2,12648,Perawatan Diri ,0,0,0,10,10,0,No,
2,12657,Makanan & Susu Bayi,0,0,0,6,6,0,No,
2,12662,Makanan & Susu Bayi,0,0,0,13,13,0,No,
2,12691,Kebutuhan Dapur,0,0,0,3,3,0,No,
2,12698,Perawatan Rumah,0,0,0,1,1,0,No,
2,12711,Shampoo & Conditioner,0,0,0,9,9,0,No,
2,12725,Shampoo & Conditioner,18,24,6,15,12,-3,33.33%,
2,12736,Perawatan Rumah,30,48,18,42,27,-15,60.00%,
2,12753,Perawatan Rumah,54,54,0,12,12,0,No,
2,12814,Perawatan Rumah,468,468,0,18,18,0,No,
2,12832,Perawatan Mulut,120,120,0,90,90,0,No,
2,12860,Snack,0,0,0,23,23,0,No,
2,12862,Snack,0,0,0,57,57,0,No,
2,12864,Snack,0,0,0,2,2,0,No,
2,12867,Snack,48,96,48,2,1,-1,100.00%,
2,12883,Sarapan,0,0,0,7,7,0,No,
2,12935,Susu & Olahan Susu,48,60,12,13,11,-2,25.00%,
2,12945,Tepung & Bahan Kue,0,80,80,55,0,-55,100.00%,Yes
2,12964,Kebersihan Badan,192,192,0,39,39,0,No,
2,12965,Kebersihan Badan,0,0,0,162,162,0,No,
2,12966,Kebersihan Badan,0,0,0,18,18,0,No,
2,12969,Kebersihan Badan,528,576,48,135,124,-11,9.09%,
2,12970,Kebersihan Badan,456,504,48,141,128,-13,10.53%,
2,13251,Snack,73,79,6,92,86,-6,8.22%,
2,13253,,234,366,132,52,34,-18,56.41%,
2,13255,Snack,129,146,17,117,104,-13,13.18%,
2,13257,,0,1,1,63,0,-63,100.00%,Yes
2,13282,Bahan Masak & Bumbu,0,0,0,8,8,0,No,
2,13316,Kebutuhan Pokok,158,282,124,10,6,-4,78.48%,
2,13343,Kebersihan Badan,0,0,0,79,79,0,No,
2,13446,Biskuit,0,0,0,27,27,0,No,
2,13450,Perawatan Rumah,0,0,0,2,2,0,No,
2,13479,Perawatan Rumah,0,0,0,59,59,0,No,
2,13494,Snack,0,0,0,11,11,0,No,
2,13546,Snack,0,0,0,20,20,0,No,
2,13570,Sarapan,0,12,12,1,0,-1,100.00%,Yes
2,13648,Sarapan,24,36,12,54,36,-18,50.00%,
2,13649,Sarapan,24,24,0,12,12,0,No,
2,13739,Kebutuhan Cuci Baju,108,132,24,1,1,0,22.22%,
2,13812,Perawatan Diri ,155,170,15,2,2,0,9.68%,
2,13902,Perawatan Rumah,216,336,120,96,62,-34,55.56%,
2,13903,Perawatan Rumah,36,60,24,88,53,-35,66.67%,
2,13904,Perawatan Rumah,384,504,120,2,2,0,31.25%,
2,13997,Shampoo & Conditioner,96,96,0,14,14,0,No,
2,14148,Perawatan Diri ,24,24,0,9,9,0,No,
2,14235,Perawatan Rumah,0,0,0,11,11,0,No,
2,14239,Perawatan Rumah,576,648,72,27,24,-3,12.50%,
2,14325,Bahan Masak & Bumbu,0,0,0,5,5,0,No,
2,14375,Perawatan Hewan,24,48,24,22,11,-11,100.00%,
2,14381,Biskuit,20,70,50,19,6,-13,250.00%,
2,14416,Perawatan Mulut,96,144,48,15,10,-5,50.00%,
2,14417,Perawatan Mulut,48,96,48,25,13,-12,100.00%,
2,14437,Cokelat,0,0,0,39,39,0,No,
2,14438,Cokelat,0,0,0,2,2,0,No,
2,14441,Cokelat,0,0,0,121,121,0,No,
2,14444,Cokelat,0,0,0,189,189,0,No,
2,14460,Snack,0,0,0,16,16,0,No,
2,14479,Kebutuhan Pokok,240,280,40,39,34,-5,16.67%,
2,14483,Kebutuhan Pokok,540,620,80,20,18,-2,14.81%,
2,14484,Kebutuhan Pokok,160,240,80,42,28,-14,50.00%,
2,14487,Kebersihan Badan,84,84,0,5,5,0,No,
2,14493,Perlengkapan Pakaian ,240,264,24,10,10,0,10.00%,
2,14494,Perlengkapan Pakaian ,720,864,144,31,26,-5,20.00%,
2,14518,Kebutuhan Pokok,0,0,0,7,7,0,No,
2,14536,Minuman,96,120,24,11,9,-2,25.00%,
2,14538,Minuman,48,72,24,14,10,-4,50.00%,
2,14539,Minuman,0,0,0,46,46,0,No,
2,14544,Minuman,360,432,72,18,15,-3,20.00%,
2,14580,Perawatan Mulut,624,912,288,20,14,-6,46.15%,
2,14595,Perawatan Mulut,48,96,48,37,19,-18,100.00%,
2,14691,Alat Kesehatan,700,900,200,162,126,-36,28.57%,
2,14768,Biskuit,50,70,20,23,17,-6,40.00%,
2,14809,Minuman,1008,1296,288,41,32,-9,28.57%,
2,14812,Kebutuhan Pokok,144,168,24,27,24,-3,16.67%,
2,14825,Minuman,96,264,168,60,22,-38,175.00%,
2,14859,Biskuit,0,80,80,133,0,-133,100.00%,Yes
2,14905,Bahan Masak & Bumbu,128,160,32,17,14,-3,25.00%,
2,14921,Tepung & Bahan Kue,150,150,0,1,1,0,No,
2,14943,Perawatan Rumah,215,200,-15,2,3,1,No,
2,15008,,18,32,14,4,3,-1,77.78%,
2,15010,,0,2,2,2,0,-2,100.00%,Yes
2,15028,Tepung & Bahan Kue,348,504,156,35,25,-10,44.83%,
2,15048,Kebersihan Wajah,0,0,0,7,7,0,No,
2,15130,Perawatan Diri ,144,144,0,44,44,0,No,
2,15188,Permen,144,180,36,57,46,-11,25.00%,
2,15302,Minuman,0,0,0,3,3,0,No,
2,15310,Minuman,144,144,0,48,48,0,No,
2,15312,Minuman,0,0,0,5,5,0,No,
2,15314,Minuman,184,184,0,20,20,0,No,
2,15366,Kebutuhan Ibu & Bayi,36,60,24,5,3,-2,66.67%,
2,15375,Bahan Masak & Bumbu,175,140,-35,6,8,2,No,
2,15434,Kebutuhan Pokok,66,66,0,8,8,0,No,
2,15448,Perawatan Rumah,96,96,0,1,1,0,No,
2,15509,Tata Rumah,85,95,10,31,28,-3,11.76%,
2,15512,Perawatan Rumah,492,492,0,38,38,0,No,
2,15520,Sarapan,0,0,0,11,11,0,No,
2,15554,Kebutuhan Pokok,0,0,0,50,50,0,No,
2,15569,,24,24,0,4,4,0,No,
2,15596,Bahan Masak & Bumbu,192,192,0,10,10,0,No,
2,15604,Bahan Masak & Bumbu,0,0,0,3,3,0,No,
2,15616,Bahan Masak & Bumbu,0,0,0,21,21,0,No,
2,15641,Kebutuhan Pokok,1200,1572,372,33,26,-7,31.00%,
2,15642,Kebutuhan Pokok,96,96,0,1,1,0,No,
2,15826,Kebutuhan Cuci Baju,36,42,6,4,4,0,16.67%,
2,15832,Kebutuhan Pokok,80,120,40,56,38,-18,50.00%,
2,15835,Kebutuhan Pokok,40,40,0,11,11,0,No,
2,15917,Sarapan,132,144,12,3,3,0,9.09%,
2,15938,Kebutuhan Cuci Baju,0,0,0,2,2,0,No,
2,15950,Kebutuhan Cuci Baju,16,16,0,1,1,0,No,
2,16120,Cokelat,0,0,0,25,25,0,No,
2,16138,Bahan Masak & Bumbu,24,120,96,1,1,0,400.00%,
2,16156,Perawatan Rumah,168,192,24,20,18,-2,14.29%,
2,16157,Perawatan Rumah,216,240,24,18,17,-1,11.11%,
2,16169,Perawatan Rumah,264,288,24,28,26,-2,9.09%,
2,16441,Biskuit,168,192,24,61,54,-7,14.29%,
2,16470,Makanan & Susu Bayi,0,0,0,1,1,0,No,
2,16538,Kebersihan Badan,0,0,0,2,2,0,No,
2,16540,Kebersihan Badan,72,72,0,33,33,0,No,
2,16587,Bahan Masak & Bumbu,168,216,48,11,9,-2,28.57%,
2,16645,Permen,12,24,12,14,7,-7,100.00%,
2,16867,Snack,300,420,120,139,100,-39,40.00%,
2,16885,Snack,540,660,120,8,7,-1,22.22%,
2,16887,Snack,0,0,0,2,2,0,No,
2,16990,Obat-obatan,100,200,100,17,9,-8,100.00%,
2,17131,Sarapan,126,126,0,6,6,0,No,
2,17258,Minuman,192,216,24,24,22,-2,12.50%,
2,17290,Perawatan Rumah,72,84,12,22,19,-3,16.67%,
2,17342,Perawatan Rumah,0,0,0,24,24,0,No,
2,17343,Perawatan Rumah,48,48,0,2,2,0,No,
2,17361,Makanan & Susu Bayi,60,60,0,10,10,0,No,
2,17468,Susu & Olahan Susu,36,108,72,6,2,-4,200.00%,
2,17514,Susu & Olahan Susu,336,384,48,78,69,-9,14.29%,
2,17593,Bahan Masak & Bumbu,240,240,0,39,39,0,No,
2,17662,Bahan Masak & Bumbu,96,120,24,15,12,-3,25.00%,
2,17768,Kebutuhan Pokok,560,600,40,69,65,-4,7.14%,
2,17770,Snack,240,264,24,58,53,-5,10.00%,
2,17772,Snack,240,264,24,21,20,-1,10.00%,
2,17773,Kebutuhan Pokok,120,120,0,49,49,0,No,
2,17780,Kebutuhan Pokok,480,520,40,85,79,-6,8.33%,
2,17809,Biskuit,432,576,144,112,84,-28,33.33%,
2,17907,Snack,192,288,96,6,4,-2,50.00%,
2,17916,Snack,168,192,24,7,7,0,14.29%,
2,18009,Kebersihan Wajah,48,48,0,34,34,0,No,
2,18076,Snack,60,60,0,17,17,0,No,
2,18078,Snack,60,60,0,4,4,0,No,
2,18081,Kebutuhan Pokok,360,400,40,22,20,-2,11.11%,
2,18085,Bahan Masak & Bumbu,120,120,0,2,2,0,No,
2,18116,Perawatan Diri ,0,0,0,3,3,0,No,
2,18118,Perawatan Diri ,0,24,24,17,0,-17,100.00%,Yes
2,18132,Perawatan Diri ,36,48,12,2,2,0,33.33%,
2,18169,Kebutuhan Cuci Baju,36,48,12,1,1,0,33.33%,
2,18174,Kebutuhan Cuci Baju,198,318,120,13,9,-4,60.61%,
2,18177,Kebutuhan Cuci Baju,0,0,0,18,18,0,No,
2,18178,Kebutuhan Cuci Baju,48,48,0,14,14,0,No,
2,18186,Kebutuhan Cuci Baju,108,156,48,1,1,0,44.44%,
2,18200,Biskuit,180,204,24,22,20,-2,13.33%,
2,18201,Obat-obatan,0,0,0,15,15,0,No,
2,18215,Obat-obatan,156,192,36,2,2,0,23.08%,
2,18218,Obat-obatan,72,108,36,7,5,-2,50.00%,
2,18297,Minuman,80,120,40,2,2,0,50.00%,
2,18360,Sarapan,200,200,0,2,2,0,No,
2,18401,Susu & Olahan Susu,504,564,60,26,24,-2,11.90%,
2,18479,Cokelat,0,0,0,47,47,0,No,
2,18580,Makanan & Susu Bayi,0,0,0,5,5,0,No,
2,18709,Sarapan,504,672,168,25,19,-6,33.33%,
2,18761,Perawatan Diri ,192,204,12,29,28,-1,6.25%,
2,18817,Minuman,30,60,30,52,26,-26,100.00%,
2,19026,Kebersihan Badan,336,336,0,114,114,0,No,
2,19085,Kebutuhan Cuci Baju,0,0,0,17,17,0,No,
2,19088,Kebutuhan Cuci Baju,96,108,12,1,1,0,12.50%,
2,19089,Kebutuhan Cuci Baju,0,0,0,2,2,0,No,
2,19098,Kebutuhan Cuci Baju,72,84,12,29,25,-4,16.67%,
2,19105,Kebutuhan Cuci Baju,198,222,24,2,2,0,12.12%,
2,19125,Bahan Masak & Bumbu,0,72,72,25,0,-25,100.00%,Yes
2,19189,Shampoo & Conditioner,48,48,0,2,2,0,No,
2,19193,Shampoo & Conditioner,62,62,0,18,18,0,No,
2,19240,Makanan & Susu Bayi,0,0,0,21,21,0,No,
2,19449,Perawatan Rumah,144,144,0,3,3,0,No,
2,19516,Sarapan,0,0,0,4,4,0,No,
2,19517,Obat-obatan,0,0,0,35,35,0,No,
2,19523,Minuman,0,0,0,2,2,0,No,
2,19536,Susu & Olahan Susu,384,384,0,8,8,0,No,
2,19574,Kebutuhan Pokok,156,180,24,45,39,-6,15.38%,
2,19721,Bahan Masak & Bumbu,36,72,36,100,50,-50,100.00%,
2,19727,Bahan Masak & Bumbu,0,0,0,35,35,0,No,
2,19788,Kebutuhan Pokok,40,158,118,31,8,-23,295.00%,
2,19810,Perawatan Diri ,588,588,0,70,70,0,No,
2,19830,Kebutuhan Pokok,444,492,48,83,75,-8,10.81%,
2,19901,Bahan Masak & Bumbu,96,132,36,5,4,-1,37.50%,
2,19952,Vitamin,0,24,24,34,0,-34,100.00%,Yes
2,20131,Perawatan Hewan,120,144,24,2,2,0,20.00%,
2,20198,Minuman,0,0,0,1,1,0,No,
2,20199,Minuman,72,108,36,19,13,-6,50.00%,
2,20277,Perawatan Hewan,280,476,196,59,35,-24,70.00%,
2,20278,Perawatan Hewan,196,252,56,1,1,0,28.57%,
2,20280,Perawatan Hewan,336,552,216,85,52,-33,64.29%,
2,20282,Perawatan Hewan,60,75,15,14,12,-2,25.00%,
2,20423,Permen,24,24,0,21,21,0,No,
2,20541,Shampoo & Conditioner,0,0,0,1,1,0,No,
2,20542,Shampoo & Conditioner,0,0,0,5,5,0,No,
2,20561,Kebutuhan Ibu & Bayi,48,48,0,6,6,0,No,
2,20570,Kebutuhan Ibu & Bayi,48,48,0,1,1,0,No,
2,20629,,96,120,24,142,114,-28,25.00%,
2,20632,Skincare,0,0,0,2,2,0,No,
2,20692,Permen,150,180,30,114,95,-19,20.00%,
2,20710,Permen,0,12,12,37,0,-37,100.00%,Yes
2,20712,Kebutuhan Ibu & Bayi,0,0,0,2,2,0,No,
2,20714,Kebutuhan Ibu & Bayi,0,0,0,6,6,0,No,
2,20726,Snack,24,24,0,3,3,0,No,
2,20727,Snack,24,24,0,12,12,0,No,
2,20740,Perawatan Rumah,0,0,0,7,7,0,No,
2,20742,Perawatan Rumah,0,0,0,2,2,0,No,
2,20751,Obat-obatan,432,576,144,6,5,-1,33.33%,
2,20795,Kebutuhan Pokok,60,60,0,9,9,0,No,
2,20904,Sarapan,0,0,0,41,41,0,No,
2,20928,Perawatan Rumah,0,36,36,65,0,-65,100.00%,Yes
2,20929,Perawatan Rumah,24,30,6,12,10,-2,25.00%,
2,20931,Perawatan Rumah,0,0,0,1,1,0,No,
2,20936,Perawatan Rumah,90,90,0,1,1,0,No,
2,20951,Sarapan,60,72,12,75,63,-12,20.00%,
2,20957,Sarapan,180,216,36,94,79,-15,20.00%,
2,21010,Perawatan Rumah,72,72,0,4,4,0,No,
2,21401,Perawatan Diri ,912,1104,192,209,173,-36,21.05%,
2,21442,Susu & Olahan Susu,48,72,24,88,59,-29,50.00%,
2,21446,Susu & Olahan Susu,96,96,0,139,139,0,No,
2,21447,Susu & Olahan Susu,84,108,24,23,18,-5,28.57%,
2,21458,Makanan & Susu Bayi,60,60,0,1,1,0,No,
2,21774,Perawatan Diri ,48,48,0,8,8,0,No,
2,21839,Obat-obatan,72,168,96,27,12,-15,133.33%,
2,21901,Snack,0,0,0,2,2,0,No,
2,22033,Bahan Masak & Bumbu,72,96,24,20,15,-5,33.33%,
2,22336,Kebutuhan Pokok,0,0,0,91,91,0,No,
2,22363,,0,0,0,5,5,0,No,
2,22420,Susu & Olahan Susu,120,120,0,13,13,0,No,
2,22421,Susu & Olahan Susu,1128,1344,216,2,2,0,19.15%,
2,22437,Kebutuhan Cuci Baju,0,0,0,29,29,0,No,
2,22527,Vitamin,48,48,0,1,1,0,No,
2,22578,Shampoo & Conditioner,96,108,12,14,13,-1,12.50%,
2,22581,Makanan & Susu Bayi,48,72,24,5,4,-1,50.00%,
2,22629,Elektronik,60,60,0,3,3,0,No,
2,22704,Fashion Aksesoris,0,0,0,2,2,0,No,
2,22731,Biskuit,216,216,0,11,11,0,No,
2,22732,Biskuit,192,344,152,32,18,-14,79.17%,
2,22737,Makanan & Susu Bayi,132,156,24,1,1,0,18.18%,
2,22882,Biskuit,27,45,18,37,23,-14,66.67%,
2,22909,Snack,24,24,0,12,12,0,No,
2,22933,Sarapan,60,96,36,147,92,-55,60.00%,
2,22934,Sarapan,36,24,-12,24,36,12,No,
2,22973,Vitamin,4,4,0,1,1,0,No,
2,23147,Kebutuhan Ibu & Bayi,60,60,0,3,3,0,No,
2,23152,Snack,108,132,24,32,27,-5,22.22%,
2,23334,Mainan & Hobi,0,0,0,5,5,0,No,
2,23361,Kebutuhan Pokok,0,0,0,9,9,0,No,
2,23365,Kebutuhan Pokok,0,0,0,6,6,0,No,
2,23437,Minuman,0,336,336,1,0,-1,100.00%,Yes
2,23573,Alat Tulis Kantor,0,0,0,3,3,0,No,
2,23586,Alat Tulis Kantor,0,0,0,1,1,0,No,
2,23710,Snack,144,168,24,56,48,-8,16.67%,
2,23711,Snack,108,120,12,37,34,-3,11.11%,
2,23721,Susu & Olahan Susu,120,120,0,4,4,0,No,
2,23835,Alat Kesehatan,120,156,36,9,7,-2,30.00%,
2,23846,Permen,320,384,64,48,40,-8,20.00%,
2,23924,Perawatan Mulut,0,108,108,63,0,-63,100.00%,Yes
2,24046,Fashion Aksesoris,0,0,0,24,24,0,No,
2,24057,Snack,144,168,24,46,40,-6,16.67%,
2,24116,Susu & Olahan Susu,48,48,0,1,1,0,No,
2,24147,Sarapan,648,612,-36,5,6,1,No,
2,24180,Perawatan Hewan,144,144,0,113,113,0,No,
2,24183,Perawatan Hewan,72,90,18,18,15,-3,25.00%,
2,24184,Perawatan Hewan,126,234,108,134,73,-61,85.71%,
2,24211,Perawatan Hewan,126,138,12,40,37,-3,9.52%,
2,24372,Snack,150,150,0,1,1,0,No,
2,24446,Perawatan Hewan,126,144,18,43,38,-5,14.29%,
2,24478,Perawatan Rumah,72,72,0,2,2,0,No,
2,24512,Kebutuhan Pokok,300,340,40,6,6,0,13.33%,
2,24559,Cokelat,0,0,0,5,5,0,No,
2,24572,Alat Tulis Kantor,0,0,0,3,3,0,No,
2,24719,Makanan & Susu Bayi,48,48,0,18,18,0,No,
2,24814,Kebutuhan Dapur,0,0,0,3,3,0,No,
2,24818,Perawatan Rumah,0,0,0,4,4,0,No,
2,24910,Kebutuhan Ibu & Bayi,6,12,6,6,3,-3,100.00%,
2,24911,Kebutuhan Ibu & Bayi,0,0,0,7,7,0,No,
2,24912,Kebutuhan Ibu & Bayi,24,56,32,18,8,-10,133.33%,
2,24914,Kebutuhan Ibu & Bayi,0,0,0,18,18,0,No,
2,24972,Minuman,24,24,0,13,13,0,No,
2,24975,Vitamin,0,0,0,2,2,0,No,
2,25108,Kebutuhan Cuci Baju,84,132,48,77,49,-28,57.14%,
2,25110,Perawatan Rumah,24,36,12,41,28,-13,50.00%,
2,25114,Kebutuhan Cuci Baju,0,0,0,2,2,0,No,
2,25115,,12,12,0,2,2,0,No,
2,25123,,66,108,42,24,15,-9,63.64%,
2,25144,Snack,144,192,48,42,32,-10,33.33%,
2,25145,Kebutuhan Pokok,216,276,60,83,65,-18,27.78%,
2,25222,Tepung & Bahan Kue,0,0,0,20,20,0,No,
2,25223,Tepung & Bahan Kue,0,0,0,11,11,0,No,
2,25273,Snack,0,0,0,8,8,0,No,
2,25276,Snack,288,320,32,86,78,-8,11.11%,
2,25278,,48,48,0,61,61,0,No,
2,25307,Snack,0,0,0,2,2,0,No,
2,25329,Bahan Masak & Bumbu,0,0,0,31,31,0,No,
2,25356,Perawatan Mulut,0,0,0,13,13,0,No,
2,25369,Makanan & Susu Bayi,16,27,11,3,2,-1,68.75%,
2,25372,,24,24,0,1,1,0,No,
2,25373,Shampoo & Conditioner,12,12,0,16,16,0,No,
2,25390,Kebersihan Wajah,45,45,0,4,4,0,No,
2,25431,Kebutuhan Ibu & Bayi,0,0,0,6,6,0,No,
2,25471,Make Up,0,0,0,114,114,0,No,
2,25496,Obat-obatan,0,0,0,2,2,0,No,
2,25502,Obat-obatan,108,180,72,40,24,-16,66.67%,
2,25505,Obat-obatan,100,100,0,45,45,0,No,
2,25520,Perawatan Hewan,72,72,0,93,93,0,No,
2,25525,Perawatan Hewan,0,0,0,23,23,0,No,
2,25526,Perawatan Hewan,0,24,24,5,0,-5,100.00%,Yes
2,25528,Perawatan Hewan,0,0,0,6,6,0,No,
2,25532,Perawatan Hewan,0,0,0,12,12,0,No,
2,25535,Perawatan Hewan,36,48,12,71,54,-17,33.33%,
2,25537,Perawatan Hewan,48,48,0,12,12,0,No,
2,25538,Perawatan Hewan,192,192,0,36,36,0,No,
2,25541,Perawatan Hewan,36,72,36,30,15,-15,100.00%,
2,25551,,150,180,30,10,9,-1,20.00%,
2,25555,Kebutuhan Ibu & Bayi,0,0,0,32,32,0,No,
2,25581,Kebutuhan Ibu & Bayi,12,12,0,1,1,0,No,
2,25619,Alat Kesehatan,0,0,0,1,1,0,No,
2,25639,Perawatan Rumah,0,0,0,1,1,0,No,
2,25668,Tata Rumah,0,0,0,36,36,0,No,
2,25674,Perawatan Rumah,560,600,40,42,40,-2,7.14%,
2,25690,Kebutuhan Cuci Baju,0,0,0,21,21,0,No,
2,25691,Kebutuhan Cuci Baju,444,492,48,8,8,0,10.81%,
2,25707,Perawatan Rumah,256,256,0,12,12,0,No,
2,25743,Perawatan Rumah,0,128,128,91,0,-91,100.00%,Yes
2,25787,Obat-obatan,250,300,50,23,20,-3,20.00%,
2,25845,Kebutuhan Cuci Baju,0,0,0,2,2,0,No,
2,25894,Perawatan Rumah,0,0,0,20,20,0,No,
2,25895,Perawatan Rumah,0,0,0,5,5,0,No,
2,25926,Perawatan Rumah,240,240,0,10,10,0,No,
2,26091,Bahan Masak & Bumbu,120,120,0,5,5,0,No,
2,26099,,118,149,31,16,13,-3,26.27%,
2,26101,,238,306,68,39,31,-8,28.57%,
2,26106,,34,34,0,8,8,0,No,
2,26128,Vitamin,0,0,0,2,2,0,No,
2,26134,Sarapan,90,120,30,49,37,-12,33.33%,
2,26135,Sarapan,90,120,30,112,84,-28,33.33%,
2,26136,Sarapan,120,120,0,124,124,0,No,
2,26137,Biskuit,144,180,36,48,39,-9,25.00%,
2,26261,Tepung & Bahan Kue,0,0,0,46,46,0,No,
2,26307,Kebutuhan Cuci Baju,36,36,0,3,3,0,No,
2,26309,Kebutuhan Cuci Baju,48,72,24,53,36,-17,50.00%,
2,26310,,0,24,24,30,0,-30,100.00%,Yes
2,26318,Perawatan Diri ,84,126,42,14,10,-4,50.00%,
2,26319,Perawatan Diri ,288,288,0,1,1,0,No,
2,26374,Kebersihan Badan,84,96,12,21,19,-2,14.29%,
2,26378,Kebersihan Badan,12,12,0,1,1,0,No,
2,26379,Kebersihan Badan,36,36,0,10,10,0,No,
2,26383,Makanan & Susu Bayi,24,24,0,6,6,0,No,
2,26400,Makanan & Susu Bayi,0,0,0,1,1,0,No,
2,26420,Makanan & Susu Bayi,60,72,12,48,40,-8,20.00%,
2,26421,Makanan & Susu Bayi,48,60,12,38,31,-7,25.00%,
2,26474,Susu & Olahan Susu,0,0,0,34,34,0,No,
2,26514,Kebutuhan Cuci Baju,0,15,15,11,0,-11,100.00%,Yes
2,26515,Kebutuhan Cuci Baju,0,0,0,2,2,0,No,
2,26519,Perawatan Rumah,0,9,9,65,0,-65,100.00%,Yes
2,26520,Perawatan Rumah,0,0,0,75,75,0,No,
2,26529,Kebutuhan Cuci Baju,180,204,24,1,1,0,13.33%,
2,26540,Alat Kesehatan,72,96,24,5,4,-1,33.33%,
2,26543,Alat Kesehatan,60,72,12,63,53,-10,20.00%,
2,26554,Alat Kesehatan,150,150,0,2,2,0,No,
2,26658,Kebutuhan Ibu & Bayi,0,0,0,1,1,0,No,
2,26661,Peralatan Ibu & Bayi,24,24,0,1,1,0,No,
2,26664,Peralatan Ibu & Bayi,48,48,0,3,3,0,No,
2,26665,Peralatan Ibu & Bayi,0,0,0,2,2,0,No,
2,26837,Bahan Masak & Bumbu,0,0,0,1,1,0,No,
2,26847,Shampoo & Conditioner,0,0,0,4,4,0,No,
2,26849,Shampoo & Conditioner,60,72,12,8,7,-1,20.00%,
2,26850,Shampoo & Conditioner,36,48,12,2,2,0,33.33%,
2,26859,Tepung & Bahan Kue,0,0,0,21,21,0,No,
2,26861,Makanan & Susu Bayi,0,0,0,41,41,0,No,
2,26945,Makanan & Susu Bayi,48,72,24,10,7,-3,50.00%,
2,26948,Makanan & Susu Bayi,0,0,0,87,87,0,No,
2,26952,Perawatan Diri ,240,312,72,69,54,-15,30.00%,
2,26956,Perawatan Diri ,168,192,24,9,8,-1,14.29%,
2,26966,Kebutuhan Pokok,200,240,40,12,10,-2,20.00%,
2,27163,Permen,480,720,240,46,31,-15,50.00%,
2,27166,Permen,24,24,0,25,25,0,No,
2,27172,Minuman,0,0,0,4,4,0,No,
2,27194,Alat Kesehatan,0,0,0,1,1,0,No,
2,27199,Perawatan Mulut,0,0,0,108,108,0,No,
2,27201,Perawatan Mulut,0,0,0,99,99,0,No,
2,27205,Kebutuhan Ibu & Bayi,36,54,18,20,14,-6,50.00%,
2,27206,Kebutuhan Ibu & Bayi,0,36,36,1,0,-1,100.00%,Yes
2,27214,Snack,30,30,0,3,3,0,No,
2,27215,Snack,0,0,0,4,4,0,No,
2,27251,Permen,200,200,0,2,2,0,No,
2,27550,Kebersihan Wajah,21,24,3,15,14,-1,14.29%,
2,27551,Make Up,240,240,0,2,2,0,No,
2,27566,Kebutuhan Ibu & Bayi,120,120,0,6,6,0,No,
2,27597,Perawatan Rumah,132,132,0,4,4,0,No,
2,27612,Perawatan Rumah,96,96,0,1,1,0,No,
2,27670,Perawatan Hewan,0,0,0,6,6,0,No,
2,27671,Perawatan Hewan,48,72,24,6,4,-2,50.00%,
2,27672,Vitamin,168,192,24,117,103,-14,14.29%,
2,27681,Vitamin,0,12,12,1,0,-1,100.00%,Yes
2,27682,Vitamin,144,168,24,115,99,-16,16.67%,
2,27725,Elektronik,120,120,0,1,1,0,No,
2,27866,Biskuit,48,48,0,1,1,0,No,
2,27978,Makanan & Susu Bayi,60,60,0,46,46,0,No,
2,27979,Makanan & Susu Bayi,0,0,0,5,5,0,No,
2,27980,Makanan & Susu Bayi,24,24,0,10,10,0,No,
2,27981,Makanan & Susu Bayi,0,0,0,24,24,0,No,
2,28009,Snack,0,0,0,3,3,0,No,
2,28083,Make Up,84,108,24,68,53,-15,28.57%,
2,28084,Make Up,96,108,12,44,40,-4,12.50%,
2,28226,Perawatan Hewan,48,48,0,41,41,0,No,
2,28237,Shampoo & Conditioner,276,312,36,22,20,-2,13.04%,
2,28263,Permen,0,96,96,127,0,-127,100.00%,Yes
2,28375,Snack,48,72,24,11,8,-3,50.00%,
2,28381,Snack,72,120,48,2,2,0,66.67%,
2,28416,Susu & Olahan Susu,1272,1272,0,1,1,0,No,
2,28535,Snack,456,624,168,112,82,-30,36.84%,
2,28576,Biskuit,153,242,89,104,66,-38,58.17%,
2,28577,Biskuit,133,212,79,43,27,-16,59.40%,
2,28579,Kebutuhan Ibu & Bayi,36,36,0,10,10,0,No,
2,28716,Susu & Olahan Susu,0,0,0,6,6,0,No,
2,28726,Snack,100,100,0,63,63,0,No,
2,28794,Perawatan Rumah,216,240,24,48,44,-4,11.11%,
2,28826,Biskuit,160,160,0,99,99,0,No,
2,28828,Sarapan,108,132,24,66,54,-12,22.22%,
2,28831,Alat Kesehatan,0,0,0,1,1,0,No,
2,28840,Perawatan Hewan,96,108,12,18,16,-2,12.50%,
2,28842,Perawatan Hewan,36,36,0,30,30,0,No,
2,28866,Snack,0,0,0,1,1,0,No,
2,28937,Perawatan Hewan,64,64,0,1,1,0,No,
2,28955,Perawatan Hewan,24,24,0,6,6,0,No,
2,28961,Perawatan Hewan,96,96,0,26,26,0,No,
2,28962,Perawatan Hewan,72,72,0,6,6,0,No,
2,28963,Perawatan Hewan,0,0,0,5,5,0,No,
2,28964,Perawatan Hewan,18,27,9,19,13,-6,50.00%,
2,28965,Perawatan Hewan,269,269,0,13,13,0,No,
2,28966,Perawatan Hewan,63,78,15,24,20,-4,23.81%,
2,28967,Perawatan Hewan,0,0,0,88,88,0,No,
2,28968,Perawatan Hewan,20,48,28,12,5,-7,140.00%,
2,28970,Perawatan Hewan,20,32,12,21,14,-7,60.00%,
2,29251,Vitamin,96,96,0,7,7,0,No,
2,29342,Bahan Masak & Bumbu,12,96,84,9,2,-7,700.00%,
2,29538,Snack,120,120,0,2,2,0,No,
2,29544,Alat Kesehatan,270,371,101,78,57,-21,37.41%,
2,29579,Perawatan Hewan,84,112,28,9,7,-2,33.33%,
2,29580,Perawatan Hewan,56,84,28,24,16,-8,50.00%,
2,29581,Perawatan Hewan,120,144,24,8,7,-1,20.00%,
2,29585,Kebutuhan Cuci Baju,64,64,0,11,11,0,No,
2,29592,Perawatan Hewan,48,60,12,1,1,0,25.00%,
2,29600,Kebutuhan Ibu & Bayi,0,0,0,25,25,0,No,
2,29601,Kebutuhan Ibu & Bayi,0,0,0,89,89,0,No,
2,29602,Kebutuhan Ibu & Bayi,120,156,36,3,3,0,30.00%,
2,29630,Sarapan,0,52,52,100,0,-100,100.00%,Yes
2,29637,Cokelat,0,0,0,206,206,0,No,
2,29647,Perawatan Diri ,336,348,12,122,118,-4,3.57%,
2,29661,Kebersihan Badan,125,144,19,41,36,-5,15.20%,
2,29662,Kebersihan Badan,180,210,30,47,41,-6,16.67%,
2,29663,Kebersihan Badan,121,143,22,44,38,-6,18.18%,
2,29711,Kebersihan Wajah,0,0,0,2,2,0,No,
2,29725,,576,720,144,22,18,-4,25.00%,
2,29760,Minuman,18,18,0,4,4,0,No,
2,29806,Susu & Olahan Susu,0,36,36,1,0,-1,100.00%,Yes
2,29909,Snack,240,288,48,1,1,0,20.00%,
2,29910,Snack,276,276,0,30,30,0,No,
2,29920,Sarapan,0,0,0,196,196,0,No,
2,29942,Sarapan,60,60,0,63,63,0,No,
2,30055,Sarapan,306,414,108,181,134,-47,35.29%,
2,30189,Makanan & Susu Bayi,0,0,0,8,8,0,No,
2,30219,Snack,35,105,70,61,21,-40,200.00%,
2,30304,Kebutuhan Pokok,100,100,0,3,3,0,No,
2,30325,Biskuit,0,0,0,1,1,0,No,
2,30326,Biskuit,0,0,0,1,1,0,No,
2,30410,Snack,0,0,0,76,76,0,No,
2,30411,Snack,0,0,0,2,2,0,No,
2,30509,Susu & Olahan Susu,24,24,0,1,1,0,No,
2,30510,Susu & Olahan Susu,0,24,24,13,0,-13,100.00%,Yes
2,30529,Snack,0,0,0,2,2,0,No,
2,30542,Bahan Masak & Bumbu,240,336,96,14,10,-4,40.00%,
2,30544,Obat-obatan,100,100,0,2,2,0,No,
2,30545,Obat-obatan,48,72,24,53,36,-17,50.00%,
2,30547,Vitamin,0,0,0,13,13,0,No,
2,30589,Bahan Masak & Bumbu,144,168,24,16,14,-2,16.67%,
2,30701,Permen,0,0,0,29,29,0,No,
2,30728,Snack,0,0,0,3,3,0,No,
2,30762,Cokelat,0,0,0,174,174,0,No,
2,30767,Kebersihan Badan,240,372,132,176,114,-62,55.00%,
2,30817,Biskuit,48,60,12,120,96,-24,25.00%,
2,30821,Perawatan Mulut,64,64,0,6,6,0,No,
2,30879,Kebersihan Badan,48,72,24,71,48,-23,50.00%,
2,30891,Kebutuhan Ibu & Bayi,24,48,24,1,1,0,100.00%,
2,31018,Snack,12,12,0,19,19,0,No,
2,31020,Snack,0,24,24,27,0,-27,100.00%,Yes
2,31021,Snack,24,24,0,6,6,0,No,
2,31024,Kebutuhan Pokok,1240,1920,680,118,77,-41,54.84%,
2,31108,Snack,48,72,24,39,26,-13,50.00%,
2,31109,Snack,144,168,24,52,45,-7,16.67%,
2,31209,Perawatan Hewan,48,96,48,1,1,0,100.00%,
2,31210,Perawatan Hewan,48,96,48,35,18,-17,100.00%,
2,31216,Skincare,0,0,0,6,6,0,No,
2,31273,Susu & Olahan Susu,0,0,0,105,105,0,No,
2,31372,Snack,200,200,0,33,33,0,No,
2,31373,Snack,300,300,0,15,15,0,No,
2,31374,Snack,10,30,20,33,11,-22,200.00%,
2,31381,Perawatan Hewan,192,192,0,1,1,0,No,
2,31383,Perawatan Hewan,300,300,0,1,1,0,No,
2,31384,Obat-obatan,0,0,0,12,12,0,No,
2,31387,Obat-obatan,0,0,0,10,10,0,No,
2,31423,Kebutuhan Cuci Baju,12,12,0,15,15,0,No,
2,31432,Vitamin,24,36,12,10,7,-3,50.00%,
2,31483,Perawatan Hewan,120,144,24,14,12,-2,20.00%,
2,31486,Perawatan Hewan,0,0,0,9,9,0,No,
2,31540,Susu & Olahan Susu,256,256,0,1,1,0,No,
2,31600,Biskuit,0,0,0,19,19,0,No,
2,31602,Biskuit,0,0,0,9,9,0,No,
2,31603,Biskuit,40,48,8,85,71,-14,20.00%,
2,31604,Perawatan Mulut,144,264,120,35,20,-15,83.33%,
2,31605,Biskuit,304,368,64,115,95,-20,21.05%,
2,31607,Biskuit,144,144,0,18,18,0,No,
2,31609,Biskuit,180,180,0,13,13,0,No,
2,31611,Kebutuhan Pokok,0,0,0,1,1,0,No,
2,31612,Shampoo & Conditioner,0,0,0,7,7,0,No,
2,31645,Perawatan Hewan,42,54,12,2,2,0,28.57%,
2,31670,Skincare,0,0,0,1,1,0,No,
2,31671,Skincare,0,2,2,7,0,-7,100.00%,Yes
2,31672,Make Up,75,104,29,41,30,-11,38.67%,
2,31706,Susu & Olahan Susu,0,0,0,5,5,0,No,
2,31735,Perawatan Rumah,32,64,32,8,4,-4,100.00%,
2,31740,Perawatan Rumah,112,144,32,22,18,-4,28.57%,
2,31817,Bahan Masak & Bumbu,0,0,0,1,1,0,No,
2,31868,Snack,250,280,30,23,21,-2,12.00%,
2,31870,Snack,370,400,30,5,5,0,8.11%,
2,31871,Snack,360,390,30,21,20,-1,8.33%,
2,31884,Susu & Olahan Susu,720,1008,288,31,23,-8,40.00%,
2,31903,Perawatan Rumah,288,384,96,47,36,-11,33.33%,
2,31910,Perawatan Rumah,96,96,0,28,28,0,No,
2,31951,Fashion Aksesoris,0,0,0,1,1,0,No,
2,31985,Perawatan Rumah,96,96,0,20,20,0,No,
2,32054,Produk 21+,1088,1244,156,23,21,-2,14.34%,
2,32058,Vitamin,3,3,0,7,7,0,No,
2,32066,Bahan Masak & Bumbu,480,600,120,16,13,-3,25.00%,
2,32068,Bahan Masak & Bumbu,1080,1440,360,15,12,-3,33.33%,
2,32083,Kebutuhan Ibu & Bayi,72,96,24,68,51,-17,33.33%,
2,32084,Kebutuhan Ibu & Bayi,24,24,0,12,12,0,No,
2,32085,Vitamin,0,80,80,124,0,-124,100.00%,Yes
2,32091,Vitamin,60,60,0,25,25,0,No,
2,32092,Vitamin,64,64,0,5,5,0,No,
2,32098,Fashion Aksesoris,0,0,0,12,12,0,No,
2,32107,Bahan Masak & Bumbu,0,50,50,1,0,-1,100.00%,Yes
2,32112,Sarapan,150,150,0,2,2,0,No,
2,32147,Perawatan Rumah,300,480,180,80,50,-30,60.00%,
2,32178,Minuman,0,0,0,35,35,0,No,
2,32194,Minuman,350,500,150,105,74,-31,42.86%,
2,32195,Minuman,150,200,50,18,14,-4,33.33%,
2,32196,Minuman,100,150,50,20,14,-6,50.00%,
2,32239,Bahan Masak & Bumbu,240,336,96,28,20,-8,40.00%,
2,32244,Minuman,202,240,38,57,48,-9,18.81%,
2,32371,Susu & Olahan Susu,60,60,0,3,3,0,No,
2,32398,Bahan Masak & Bumbu,96,96,0,1,1,0,No,
2,32417,Susu & Olahan Susu,0,0,0,78,78,0,No,
2,32442,Kebutuhan Pokok,320,440,120,1,1,0,37.50%,
2,32503,Susu & Olahan Susu,96,96,0,36,36,0,No,
2,32549,,0,0,0,8,8,0,No,
2,32551,Susu & Olahan Susu,0,0,0,1,1,0,No,
2,32598,Susu & Olahan Susu,0,0,0,9,9,0,No,
2,32606,Obat-obatan,1272,1476,204,2,2,0,16.04%,
2,32617,Perawatan Hewan,0,0,0,11,11,0,No,
2,32620,Perawatan Hewan,0,0,0,1,1,0,No,
2,32678,Minuman,0,0,0,1,1,0,No,
2,32710,Susu & Olahan Susu,0,0,0,1,1,0,No,
2,32715,Bahan Masak & Bumbu,24,48,24,22,11,-11,100.00%,
2,32735,Snack,0,0,0,125,125,0,No,
2,32738,Bahan Masak & Bumbu,0,120,120,16,0,-16,100.00%,Yes
2,32746,Perawatan Diri ,264,300,36,114,101,-13,13.64%,
2,32747,Perawatan Diri ,60,72,12,107,90,-17,20.00%,
2,32834,Perawatan Mulut,480,624,144,52,40,-12,30.00%,
2,32835,Kebersihan Badan,48,72,24,22,15,-7,50.00%,
2,32836,Kebersihan Badan,48,72,24,32,22,-10,50.00%,
2,32838,Perawatan Diri ,0,0,0,2,2,0,No,
2,32840,Perawatan Diri ,0,0,0,28,28,0,No,
2,32841,Perawatan Diri ,0,0,0,35,35,0,No,
2,32842,Perawatan Diri ,72,72,0,47,47,0,No,
2,32843,Perawatan Diri ,0,0,0,92,92,0,No,
2,32883,Susu & Olahan Susu,0,0,0,13,13,0,No,
2,32984,Sarapan,112,160,48,111,78,-33,42.86%,
2,32986,Sarapan,64,96,32,49,33,-16,50.00%,
2,32998,Obat-obatan,420,492,72,2,2,0,17.14%,
2,33053,Makanan & Susu Bayi,0,0,0,6,6,0,No,
2,33081,Vitamin,0,0,0,2,2,0,No,
2,33082,Vitamin,0,0,0,15,15,0,No,
2,33084,Bahan Masak & Bumbu,0,40,40,11,0,-11,100.00%,Yes
2,33085,Vitamin,72,72,0,8,8,0,No,
2,33243,Snack,0,0,0,12,12,0,No,
2,33244,Snack,0,0,0,13,13,0,No,
2,33245,Snack,0,0,0,28,28,0,No,
2,33247,Cokelat,0,0,0,152,152,0,No,
2,33277,Bahan Masak & Bumbu,336,384,48,89,78,-11,14.29%,
2,33304,Bahan Masak & Bumbu,300,300,0,24,24,0,No,
2,33317,Skincare,18,18,0,2,2,0,No,
2,33372,Obat-obatan,0,0,0,60,60,0,No,
2,33394,Vitamin,60,140,80,90,39,-51,133.33%,
2,33513,Kebutuhan Pokok,0,0,0,1,1,0,No,
2,33514,Kebutuhan Pokok,0,0,0,51,51,0,No,
2,33515,Kebutuhan Pokok,0,0,0,2,2,0,No,
2,33520,Obat-obatan,8,8,0,1,1,0,No,
2,33581,Skincare,8,8,0,3,3,0,No,
2,33659,Vitamin,0,0,0,8,8,0,No,
2,33685,Biskuit,420,520,100,18,15,-3,23.81%,
2,33686,Biskuit,120,240,120,36,18,-18,100.00%,
2,33736,Fashion Aksesoris,0,0,0,25,25,0,No,
2,33737,Fashion Aksesoris,0,0,0,1,1,0,No,
2,33738,Fashion Aksesoris,0,0,0,41,41,0,No,
2,33745,Obat-obatan,0,0,0,3,3,0,No,
2,33756,Kebersihan Wajah,132,156,24,22,19,-3,18.18%,
2,33787,Cokelat,0,0,0,203,203,0,No,
2,33789,Susu & Olahan Susu,0,0,0,1,1,0,No,
2,33855,Alat Tulis Kantor,0,0,0,2,2,0,No,
2,33856,Alat Tulis Kantor,0,0,0,14,14,0,No,
2,33878,Produk 21+,69,69,0,1,1,0,No,
2,33879,Produk 21+,155,155,0,10,10,0,No,
2,33880,Produk 21+,151,163,12,6,6,0,7.95%,
2,33882,Produk 21+,105,105,0,3,3,0,No,
2,33883,Produk 21+,114,131,17,97,85,-12,14.91%,
2,33884,Produk 21+,65,78,13,49,41,-8,20.00%,
2,33937,Susu & Olahan Susu,294,384,90,72,56,-16,30.61%,
2,33957,Obat-obatan,0,8,8,55,0,-55,100.00%,Yes
2,33958,Obat-obatan,0,0,0,13,13,0,No,
2,33959,Obat-obatan,0,0,0,9,9,0,No,
2,33960,Obat-obatan,2,2,0,4,4,0,No,
2,33975,Produk 21+,480,480,0,52,52,0,No,
2,34014,Obat-obatan,55,80,25,32,22,-10,45.45%,
2,34031,Minuman,96,108,12,32,29,-3,12.50%,
2,34059,Permen,0,0,0,2,2,0,No,
2,34062,Skincare,60,90,30,8,6,-2,50.00%,
2,34063,Skincare,0,0,0,8,8,0,No,
2,34065,Skincare,60,60,0,6,6,0,No,
2,34066,Skincare,0,60,60,62,0,-62,100.00%,Yes
2,34161,Vitamin,0,0,0,25,25,0,No,
2,34162,Vitamin,0,0,0,14,14,0,No,
2,34164,Kebersihan Wajah,0,0,0,6,6,0,No,
2,34205,Obat-obatan,0,0,0,25,25,0,No,
2,34276,Kebersihan Wajah,120,180,60,15,10,-5,50.00%,
2,34277,Kebersihan Wajah,120,120,0,6,6,0,No,
2,34309,Kebutuhan Ibu & Bayi,0,0,0,11,11,0,No,
2,34312,Kebutuhan Ibu & Bayi,0,0,0,36,36,0,No,
2,34339,Cokelat,0,0,0,135,135,0,No,
2,34351,Makanan & Susu Bayi,72,72,0,12,12,0,No,
2,34352,Makanan & Susu Bayi,84,120,36,47,33,-14,42.86%,
2,34353,Makanan & Susu Bayi,72,96,24,60,45,-15,33.33%,
2,34414,Susu & Olahan Susu,120,152,32,156,124,-32,26.67%,
2,34418,Biskuit,272,368,96,141,105,-36,35.29%,
2,34423,Kebutuhan Ibu & Bayi,72,72,0,99,99,0,No,
2,34455,Alat Tulis Kantor,0,0,0,63,63,0,No,
2,34456,Alat Tulis Kantor,14,14,0,6,6,0,No,
2,34468,Alat Tulis Kantor,22,32,10,10,7,-3,45.45%,
2,34478,Alat Tulis Kantor,23,29,6,53,43,-10,26.09%,
2,34479,Alat Tulis Kantor,65,77,12,39,33,-6,18.46%,
2,34489,Snack,312,456,144,197,135,-62,46.15%,
2,34528,Sarapan,0,0,0,196,196,0,No,
2,34529,Perawatan Rumah,12,24,12,78,39,-39,100.00%,
2,34531,Perawatan Rumah,12,24,12,8,4,-4,100.00%,
2,34532,Perawatan Rumah,300,300,0,150,150,0,No,
2,34533,Perawatan Rumah,0,24,24,58,0,-58,100.00%,Yes
2,34558,Perawatan Hewan,90,113,23,6,5,-1,25.56%,
2,34560,Perawatan Hewan,142,170,28,29,25,-4,19.72%,
2,34561,Perawatan Hewan,84,116,32,31,23,-8,38.10%,
2,34562,,181,248,67,42,31,-11,37.02%,
2,34563,Perawatan Hewan,100,184,84,6,4,-2,84.00%,
2,34564,Perawatan Hewan,75,129,54,40,24,-16,72.00%,
2,34575,Perawatan Rumah,240,378,138,1,1,0,57.50%,
2,34596,Make Up,0,24,24,40,0,-40,100.00%,Yes
2,34597,Make Up,0,0,0,20,20,0,No,
2,34598,Make Up,0,0,0,8,8,0,No,
2,34619,Tepung & Bahan Kue,0,0,0,10,10,0,No,
2,34701,Produk 21+,60,80,20,4,3,-1,33.33%,
2,34707,Snack,0,0,0,18,18,0,No,
2,34711,Tepung & Bahan Kue,0,0,0,8,8,0,No,
2,34712,Snack,90,108,18,56,47,-9,20.00%,
2,34713,Snack,18,18,0,2,2,0,No,
2,34722,Kebutuhan Ibu & Bayi,0,12,12,23,0,-23,100.00%,Yes
2,34730,Permen,144,192,48,32,24,-8,33.33%,
2,34738,Make Up,0,0,0,4,4,0,No,
2,34739,Make Up,0,24,24,17,0,-17,100.00%,Yes
2,34740,Make Up,24,24,0,3,3,0,No,
2,34741,Skincare,100,150,50,2,2,0,50.00%,
2,34752,Shampoo & Conditioner,0,0,0,14,14,0,No,
2,34774,Snack,48,48,0,2,2,0,No,
2,34776,Make Up,72,72,0,35,35,0,No,
2,34779,Biskuit,0,24,24,88,0,-88,100.00%,Yes
2,34786,Make Up,240,288,48,7,6,-1,20.00%,
2,34838,Biskuit,216,264,48,75,62,-13,22.22%,
2,34842,Biskuit,144,144,0,7,7,0,No,
2,34843,Biskuit,0,0,0,1,1,0,No,
2,34876,Kebersihan Wajah,48,48,0,2,2,0,No,
2,34928,,0,0,0,2,2,0,No,
2,34935,HP & Gadget,0,0,0,11,11,0,No,
2,34948,Vitamin,0,0,0,98,98,0,No,
2,34949,Vitamin,0,0,0,14,14,0,No,
2,34950,,260,270,10,56,54,-2,3.85%,
2,34951,,220,220,0,56,56,0,No,
2,34989,Skincare,264,264,0,190,190,0,No,
2,34990,Skincare,360,432,72,203,170,-33,20.00%,
2,35040,Shampoo & Conditioner,80,80,0,54,54,0,No,
2,35041,Perawatan Mulut,96,96,0,25,25,0,No,
2,35044,Kebersihan Badan,72,72,0,15,15,0,No,
2,35045,Shampoo & Conditioner,50,50,0,7,7,0,No,
2,35047,Obat-obatan,0,0,0,2,2,0,No,
2,35063,Sarapan,288,384,96,120,90,-30,33.33%,
2,35139,Make Up,0,0,0,7,7,0,No,
2,35157,Kebutuhan Dapur,0,0,0,8,8,0,No,
2,35164,Kebutuhan Ibu & Bayi,0,0,0,56,56,0,No,
2,35165,Kebutuhan Ibu & Bayi,0,0,0,9,9,0,No,
2,35166,Kebutuhan Ibu & Bayi,0,0,0,14,14,0,No,
2,35187,Biskuit,80,160,80,164,82,-82,100.00%,
2,35188,Biskuit,160,240,80,68,46,-22,50.00%,
2,35189,Biskuit,0,0,0,18,18,0,No,
2,35190,Biskuit,90,90,0,13,13,0,No,
2,35241,Minuman,144,240,96,13,8,-5,66.67%,
2,35255,Minuman,72,72,0,7,7,0,No,
2,35260,Vitamin,15,25,10,9,6,-3,66.67%,
2,35262,Vitamin,0,10,10,3,0,-3,100.00%,Yes
2,35265,Perawatan Diri ,72,72,0,2,2,0,No,
2,35266,Perawatan Diri ,0,0,0,1,1,0,No,
2,35289,Snack,150,175,25,96,83,-13,16.67%,
2,35292,Snack,160,160,0,2,2,0,No,
2,35332,Snack,0,24,24,37,0,-37,100.00%,Yes
2,35342,Obat-obatan,48,60,12,94,76,-18,25.00%,
2,35363,Susu & Olahan Susu,0,0,0,24,24,0,No,
2,35372,Kids Selection,160,169,9,35,34,-1,5.63%,
2,35382,Minuman,288,288,0,66,66,0,No,
2,35383,Minuman,0,0,0,15,15,0,No,
2,35384,Minuman,0,0,0,146,146,0,No,
2,35425,Makanan & Susu Bayi,0,0,0,1,1,0,No,
2,35426,Makanan & Susu Bayi,0,0,0,12,12,0,No,
2,35431,Makanan & Susu Bayi,0,0,0,3,3,0,No,
2,35432,Makanan & Susu Bayi,0,0,0,12,12,0,No,
2,35459,Susu & Olahan Susu,264,288,24,6,6,0,9.09%,
2,35461,Susu & Olahan Susu,312,360,48,10,9,-1,15.38%,
2,35549,Shampoo & Conditioner,35,35,0,4,4,0,No,
2,35550,Shampoo & Conditioner,0,24,24,12,0,-12,100.00%,Yes
2,35552,Tepung & Bahan Kue,144,204,60,54,39,-15,41.67%,
2,35757,Produk 21+,100,100,0,3,3,0,No,
2,35766,Sarapan,36,36,0,22,22,0,No,
2,35771,,160,200,40,91,73,-18,25.00%,
2,35772,Permen,216,216,0,30,30,0,No,
2,35796,Obat-obatan,0,0,0,7,7,0,No,
2,35802,Kebutuhan Cuci Baju,96,120,24,10,8,-2,25.00%,
2,35807,Shampoo & Conditioner,212,238,26,15,14,-1,12.26%,
2,35808,Perawatan Mulut,122,139,17,5,5,0,13.93%,
2,35824,Make Up,0,0,0,64,64,0,No,
2,35825,Make Up,2,2,0,168,168,0,No,
2,35826,Make Up,0,0,0,147,147,0,No,
2,35827,Make Up,0,0,0,28,28,0,No,
2,35828,Make Up,0,0,0,60,60,0,No,
2,35844,Kebutuhan Pokok,800,1040,240,101,78,-23,30.00%,
2,35845,Kebutuhan Pokok,120,120,0,38,38,0,No,
2,35846,Kebutuhan Pokok,1800,2040,240,170,150,-20,13.33%,
2,35847,Kebutuhan Pokok,280,360,80,78,61,-17,28.57%,
2,35849,Susu & Olahan Susu,384,456,72,17,15,-2,18.75%,
2,35950,Perawatan Rumah,48,48,0,3,3,0,No,
2,36208,Minuman,0,0,0,63,63,0,No,
2,36209,Minuman,54,90,36,106,64,-42,66.67%,
2,36224,Obat-obatan,0,0,0,73,73,0,No,
2,36227,Obat-obatan,0,0,0,7,7,0,No,
2,36231,Perawatan Rumah,204,221,17,43,40,-3,8.33%,
2,36232,Obat-obatan,0,0,0,3,3,0,No,
2,36248,Kebutuhan Cuci Baju,0,0,0,18,18,0,No,
2,36255,Peralatan Dapur,48,48,0,2,2,0,No,
2,36268,Minuman,48,68,20,20,15,-5,41.67%,
2,36280,Vitamin,0,0,0,12,12,0,No,
2,36319,Make Up,6,12,6,5,3,-2,100.00%,
2,36401,Skincare,44,49,5,7,7,0,11.36%,
2,36402,Skincare,10,20,10,7,4,-3,100.00%,
2,36403,Skincare,0,0,0,3,3,0,No,
2,36416,Susu & Olahan Susu,0,0,0,1,1,0,No,
2,36417,Susu & Olahan Susu,216,336,120,1,1,0,55.56%,
2,36449,Makanan & Susu Bayi,0,0,0,7,7,0,No,
2,36451,Tepung & Bahan Kue,227,244,17,63,59,-4,7.49%,
2,36452,Makanan & Susu Bayi,0,0,0,11,11,0,No,
2,36453,Makanan & Susu Bayi,24,24,0,2,2,0,No,
2,36454,Makanan & Susu Bayi,0,0,0,68,68,0,No,
2,36458,Makanan & Susu Bayi,0,0,0,6,6,0,No,
2,36459,Makanan & Susu Bayi,0,0,0,48,48,0,No,
2,36473,Snack,36,60,24,10,6,-4,66.67%,
2,36474,Snack,36,48,12,1,1,0,33.33%,
2,36475,Snack,96,96,0,1,1,0,No,
2,36497,Makanan & Susu Bayi,12,12,0,28,28,0,No,
2,36504,Snack,240,312,72,12,10,-2,30.00%,
2,36505,Snack,48,48,0,18,18,0,No,
2,36506,Snack,48,60,12,27,22,-5,25.00%,
2,36511,Obat-obatan,0,0,0,35,35,0,No,
2,36512,Obat-obatan,146,159,13,55,51,-4,8.90%,
2,36513,Perawatan Hewan,24,24,0,7,7,0,No,
2,36514,Perawatan Hewan,48,48,0,7,7,0,No,
2,36516,Perawatan Hewan,0,24,24,2,0,-2,100.00%,Yes
2,36591,Minuman,473,583,110,189,154,-35,23.26%,
2,36595,Perlengkapan Pakaian ,504,733,229,45,31,-14,45.44%,
2,36603,,0,0,0,122,122,0,No,
2,36605,Alat Kesehatan,120,171,51,27,19,-8,42.50%,
2,36644,Kids Selection,101,104,3,72,70,-2,2.97%,
2,36645,Kids Selection,178,190,12,116,109,-7,6.74%,
2,36646,Kids Selection,40,40,0,7,7,0,No,
2,36648,Tata Rumah,140,140,0,83,83,0,No,
2,36651,Alat Kesehatan,64,101,37,2,2,0,57.81%,
2,36652,Alat Kesehatan,22,38,16,13,8,-5,72.73%,
2,36653,Alat Kesehatan,5,17,12,9,3,-6,240.00%,
2,36662,Snack,96,96,0,85,85,0,No,
2,36663,Snack,144,192,48,97,73,-24,33.33%,
2,36664,Snack,288,288,0,138,138,0,No,
2,36671,Bahan Masak & Bumbu,0,12,12,21,0,-21,100.00%,Yes
2,36673,Bahan Masak & Bumbu,108,108,0,12,12,0,No,
2,36674,Bahan Masak & Bumbu,36,36,0,48,48,0,No,
2,36675,Minuman,0,30,30,38,0,-38,100.00%,Yes
2,36677,Tepung & Bahan Kue,130,170,40,13,10,-3,30.77%,
2,36680,Kebutuhan Pokok,0,0,0,12,12,0,No,
2,36707,Perawatan Hewan,128,128,0,9,9,0,No,
2,36708,Vitamin,2,2,0,3,3,0,No,
2,36710,Vitamin,0,0,0,14,14,0,No,
2,36714,Perawatan Hewan,0,0,0,1,1,0,No,
2,36716,Perawatan Hewan,0,0,0,1,1,0,No,
2,36717,Perawatan Hewan,0,0,0,9,9,0,No,
2,36719,Perawatan Hewan,128,192,64,32,22,-10,50.00%,
2,36721,Perawatan Hewan,128,192,64,10,7,-3,50.00%,
2,36748,Perawatan Diri ,0,0,0,42,42,0,No,
2,36755,Make Up,0,0,0,10,10,0,No,
2,36770,Tepung & Bahan Kue,0,48,48,58,0,-58,100.00%,Yes
2,36784,Snack,264,348,84,96,73,-23,31.82%,
2,36785,,312,360,48,117,102,-15,15.38%,
2,36796,Vitamin,16,16,0,5,5,0,No,
2,36797,Vitamin,15,15,0,8,8,0,No,
2,36798,Vitamin,18,18,0,39,39,0,No,
2,36799,Vitamin,35,39,4,31,28,-3,11.43%,
2,36802,Vitamin,0,0,0,56,56,0,No,
2,36803,Peralatan Ibu & Bayi,118,133,15,43,39,-4,12.71%,
2,36808,Shampoo & Conditioner,48,45,-3,5,6,1,No,
2,36845,Sarapan,0,120,120,44,0,-44,100.00%,Yes
2,36877,Minuman,168,216,48,35,28,-7,28.57%,
2,36878,Minuman,72,72,0,6,6,0,No,
2,36879,Minuman,72,96,24,18,14,-4,33.33%,
2,36916,Makanan & Susu Bayi,0,0,0,15,15,0,No,
2,36917,Bahan Masak & Bumbu,144,192,48,7,6,-1,33.33%,
2,36918,Bahan Masak & Bumbu,96,96,0,5,5,0,No,
2,36919,Makanan & Susu Bayi,0,0,0,6,6,0,No,
2,36920,Makanan & Susu Bayi,48,48,0,1,1,0,No,
2,36924,Bahan Masak & Bumbu,0,0,0,10,10,0,No,
2,36926,Bahan Masak & Bumbu,144,144,0,9,9,0,No,
2,36927,Bahan Masak & Bumbu,48,48,0,9,9,0,No,
2,36928,Bahan Masak & Bumbu,192,240,48,16,13,-3,25.00%,
2,36929,Bahan Masak & Bumbu,96,120,24,5,4,-1,25.00%,
2,36939,Kebutuhan Pokok,0,0,0,29,29,0,No,
2,36946,Alat Kesehatan,200,400,200,42,21,-21,100.00%,
2,36969,Kebutuhan Pokok,260,260,0,1,1,0,No,
2,36972,Snack,200,220,20,58,53,-5,10.00%,
2,36973,Snack,180,210,30,38,33,-5,16.67%,
2,36976,Gas & Air Galon,1044,1145,101,162,148,-14,9.67%,
2,36978,Peralatan Dapur,30,30,0,15,15,0,No,
2,36979,Peralatan Dapur,475,514,39,189,175,-14,8.21%,
2,36981,Alat Tulis Kantor,615,669,54,117,108,-9,8.78%,
2,36985,Make Up,6,12,6,1,1,0,100.00%,
2,36988,Make Up,3,3,0,8,8,0,No,
2,36989,Make Up,5,5,0,30,30,0,No,
2,36997,Make Up,81,95,14,38,33,-5,17.28%,
2,37011,Tepung & Bahan Kue,0,0,0,64,64,0,No,
2,37018,Tata Rumah,179,192,13,32,30,-2,7.26%,
2,37019,Perawatan Hewan,0,0,0,77,77,0,No,
2,37021,Make Up,165,195,30,133,113,-20,18.18%,
2,37023,Tata Rumah,0,0,0,16,16,0,No,
2,37033,Kebutuhan Ibu & Bayi,36,36,0,4,4,0,No,
2,37035,HP & Gadget,177,192,15,11,11,0,8.47%,
2,37047,Snack,320,320,0,11,11,0,No,
2,37048,Snack,72,72,0,70,70,0,No,
2,37121,Kebersihan Badan,162,205,43,4,4,0,26.54%,
2,37122,Kebersihan Badan,267,319,52,34,29,-5,19.48%,
2,37123,Kebersihan Badan,172,208,36,12,10,-2,20.93%,
2,37159,Minuman,24,24,0,60,60,0,No,
2,37176,Kebutuhan Pokok,0,36,36,9,0,-9,100.00%,Yes
2,37187,Make Up,55,64,9,44,38,-6,16.36%,
2,37189,Make Up,6,6,0,12,12,0,No,
2,37198,Make Up,6,6,0,8,8,0,No,
2,37199,Make Up,2,2,0,6,6,0,No,
2,37486,Kebutuhan Pokok,145,160,15,11,10,-1,10.34%,
2,37487,Kebutuhan Pokok,1080,1200,120,16,15,-1,11.11%,
2,37544,Alat Kesehatan,1070,1145,75,80,75,-5,7.01%,
2,37574,Fashion Aksesoris,108,120,12,56,51,-5,11.11%,
2,37580,Fashion Aksesoris,180,204,24,75,67,-8,13.33%,
2,37658,Snack,960,1080,120,56,50,-6,12.50%,
2,37659,Snack,150,150,0,74,74,0,No,
2,37660,Snack,270,270,0,105,105,0,No,
2,37661,Snack,270,300,30,119,108,-11,11.11%,
2,37662,Snack,150,150,0,56,56,0,No,
2,37663,Snack,180,210,30,79,68,-11,16.67%,
2,37665,Cokelat,96,108,12,114,102,-12,12.50%,
2,37666,Snack,120,120,0,14,14,0,No,
2,37667,Snack,60,120,60,11,6,-5,100.00%,
2,37668,Snack,0,0,0,30,30,0,No,
2,37670,Snack,96,104,8,79,73,-6,8.33%,
2,37672,Snack,0,0,0,13,13,0,No,
2,37681,,0,0,0,56,56,0,No,
2,37684,Kebutuhan Cuci Baju,93,122,29,139,106,-33,31.18%,
2,37685,Kebutuhan Cuci Baju,503,559,56,10,9,-1,11.13%,
2,37687,Perawatan Rumah,269,298,29,48,44,-4,10.78%,
2,37690,Peralatan Ibu & Bayi,128,147,19,4,4,0,14.84%,
2,37812,Perawatan Hewan,10,10,0,1,1,0,No,
2,37813,Perawatan Hewan,138,188,50,32,24,-8,36.23%,
2,38446,Perawatan Diri ,30,36,6,1,1,0,20.00%,
2,38449,Susu & Olahan Susu,0,0,0,50,50,0,No,
2,38450,Susu & Olahan Susu,0,0,0,91,91,0,No,
2,38735,Susu & Olahan Susu,120,168,48,42,30,-12,40.00%,
2,38799,Snack,90,102,12,48,43,-5,13.33%,
2,38800,Snack,12,12,0,26,26,0,No,
2,39035,Perawatan Diri ,27,31,4,9,8,-1,14.81%,
2,39036,Perawatan Hewan,0,0,0,4,4,0,No,
2,39037,Perawatan Hewan,0,0,0,3,3,0,No,
2,39038,Perawatan Hewan,0,0,0,1,1,0,No,
2,39039,Perawatan Hewan,80,80,0,15,15,0,No,
2,39087,Permen,0,0,0,3,3,0,No,
2,39514,Make Up,6,6,0,26,26,0,No,
2,39515,Make Up,6,6,0,27,27,0,No,
2,40314,Kebutuhan Pokok,156,168,12,114,106,-8,7.69%,
2,40315,Perawatan Mulut,0,0,0,17,17,0,No,
2,40317,Perawatan Mulut,3,3,0,10,10,0,No,
2,40330,Skincare,0,0,0,5,5,0,No,
2,40377,Minuman,0,0,0,27,27,0,No,
2,40378,Minuman,0,0,0,20,20,0,No,
2,40387,Make Up,1,1,0,19,19,0,No,
2,40388,Make Up,51,51,0,16,16,0,No,
2,40389,Make Up,51,51,0,10,10,0,No,
2,40390,Make Up,49,49,0,15,15,0,No,
2,40391,Make Up,51,51,0,13,13,0,No,
2,40392,Make Up,57,57,0,42,42,0,No,
2,40393,Make Up,53,53,0,21,21,0,No,
2,40394,Make Up,53,53,0,12,12,0,No,
2,40395,Make Up,54,54,0,28,28,0,No,
2,40396,Make Up,54,54,0,31,31,0,No,
2,40397,Make Up,52,52,0,12,12,0,No,
2,40398,Make Up,51,51,0,26,26,0,No,
2,40399,Make Up,52,52,0,20,20,0,No,
2,40400,Make Up,48,48,0,8,8,0,No,
2,40401,Make Up,51,51,0,22,22,0,No,
2,40402,Make Up,50,50,0,2,2,0,No,
2,40403,Make Up,53,53,0,27,27,0,No,
2,40404,Make Up,51,51,0,24,24,0,No,
2,40405,Make Up,53,53,0,15,15,0,No,
2,40406,Make Up,47,47,0,4,4,0,No,
2,40407,Make Up,52,52,0,16,16,0,No,
2,40408,Make Up,51,51,0,4,4,0,No,
2,40409,Make Up,0,0,0,6,6,0,No,
2,40412,Vitamin,0,0,0,7,7,0,No,
2,40413,Vitamin,0,0,0,7,7,0,No,
2,40414,Vitamin,0,0,0,7,7,0,No,
2,40417,Alat Kesehatan,0,0,0,26,26,0,No,
2,40419,Obat-obatan,0,0,0,21,21,0,No,
2,40422,Obat-obatan,0,0,0,38,38,0,No,
2,40423,Obat-obatan,0,0,0,38,38,0,No,
2,40443,Perawatan Mulut,0,0,0,3,3,0,No,
2,40456,Shampoo & Conditioner,0,0,0,55,55,0,No,
2,40459,Kebersihan Wajah,24,26,2,48,45,-3,8.33%,
2,40460,Perawatan Diri ,0,0,0,14,14,0,No,
2,40461,Perawatan Diri ,0,0,0,59,59,0,No,
2,40462,Perawatan Diri ,0,0,0,16,16,0,No,
2,40463,Perawatan Diri ,0,0,0,35,35,0,No,
2,40464,Perawatan Diri ,0,0,0,1,1,0,No,
2,40630,Sarapan,0,0,0,44,44,0,No,
2,40634,Perawatan Hewan,0,0,0,64,64,0,No,
2,40635,Perawatan Hewan,0,0,0,8,8,0,No,
2,40636,Perawatan Hewan,0,0,0,1,1,0,No,
2,40638,Perawatan Hewan,0,0,0,53,53,0,No,
2,40639,Perawatan Hewan,0,0,0,22,22,0,No,
2,40640,Perawatan Hewan,0,0,0,58,58,0,No,
2,40641,Perawatan Hewan,0,0,0,36,36,0,No,
2,40642,Perawatan Hewan,0,0,0,41,41,0,No,
2,40643,Perawatan Hewan,0,0,0,17,17,0,No,
2,40644,Perawatan Hewan,0,0,0,34,34,0,No,
2,40645,Perawatan Hewan,0,0,0,101,101,0,No,
2,40646,Perawatan Hewan,0,0,0,44,44,0,No,
2,40647,Perawatan Hewan,0,0,0,26,26,0,No,
2,40648,Perawatan Hewan,0,0,0,19,19,0,No,
2,40649,Perawatan Hewan,0,0,0,23,23,0,No,
2,40650,Perawatan Hewan,0,0,0,17,17,0,No,
2,40651,Perawatan Hewan,0,0,0,26,26,0,No,
2,40652,Perawatan Hewan,0,0,0,46,46,0,No,
2,40653,Perawatan Hewan,0,0,0,43,43,0,No,
2,40654,Perawatan Hewan,0,0,0,5,5,0,No,
2,40655,Perawatan Hewan,0,0,0,13,13,0,No,
2,40667,Bahan Masak & Bumbu,20,20,0,7,7,0,No,
2,40677,Snack,0,0,0,30,30,0,No,
2,40678,Snack,0,0,0,40,40,0,No,
2,40679,Snack,0,0,0,8,8,0,No,
2,40680,Snack,0,0,0,5,5,0,No,
2,40681,Snack,0,0,0,16,16,0,No,
2,40690,Biskuit,0,0,0,6,6,0,No,
2,40691,Biskuit,0,0,0,5,5,0,No,
2,40693,Biskuit,0,0,0,1,1,0,No,
2,40700,Perawatan Rumah,0,0,0,58,58,0,No,
2,40701,Snack,0,0,0,36,36,0,No,
2,40726,Minuman,13,13,0,60,60,0,No,
2,40730,Vitamin,0,0,0,2,2,0,No,
2,40731,Vitamin,0,0,0,7,7,0,No,
2,40732,Vitamin,0,0,0,7,7,0,No,
2,40774,Kebutuhan Pokok,0,0,0,86,86,0,No,
2,40778,Obat-obatan,0,0,0,120,120,0,No,
2,40804,Peralatan Dapur,100,100,0,19,19,0,No,
2,40812,Alat Tulis Kantor,0,0,0,56,56,0,No,
2,40816,Perawatan Diri ,100,100,0,40,40,0,No,
2,40831,Make Up,6,6,0,1,1,0,No,
2,40832,Make Up,6,6,0,11,11,0,No,
2,40839,Minuman,0,0,0,7,7,0,No,
2,40845,Peralatan Dapur,0,0,0,120,120,0,No,
2,40861,Bahan Masak & Bumbu,0,0,0,63,63,0,No,
2,40878,Bahan Masak & Bumbu,0,0,0,35,35,0,No,
2,40884,,0,0,0,63,63,0,No,
2,40886,,0,0,0,55,55,0,No,
2,40887,Snack,0,0,0,55,55,0,No,
2,40892,Snack,0,0,0,47,47,0,No,
2,40893,Snack,0,0,0,8,8,0,No,
2,40913,Peralatan Dapur,100,100,0,1,1,0,No,
2,40915,Produk 21+,0,0,0,9,9,0,No,
2,40916,Produk 21+,0,0,0,5,5,0,No,
2,40923,Produk 21+,0,0,0,1,1,0,No,
2,40924,Peralatan Dapur,7,7,0,49,49,0,No,
2,41046,Sarapan,0,0,0,2,2,0,No,
2,41048,Sarapan,0,0,0,134,134,0,No,
2,41120,Perlengkapan Pesta,0,0,0,1,1,0,No,
2,41121,Perlengkapan Pesta,0,0,0,8,8,0,No,
2,41277,Perawatan Diri ,0,0,0,71,71,0,No,